reservedName	reason	matchWholeName
s	s	b
''	name_declined_syntax	
--	name_declined_syntax	
"(d|pr)[il]+[ck]{1,3}"	name_declined_profane	1
"(f|ff|ph|pf)[uv]+[ck]{1,3}"	name_declined_profane	1
[^a-z1-9 '-]	name_declined_syntax	1
[^a-z '-]	name_declined_number	1
[ck][uv]+n+[iy]	name_declined_profane	1
[ck]ock	name_declined_profane	1
[ei]mp[oea]r[oea]r	name_declined_reserved	1
[jg][eo]+r+[ghj].*l+[eou]+[ck]+a+s	name_declined_developer	1
"[szc]{1,3}h[il]+t"	name_declined_profane	1
\*dev\*	name_declined_developer	
\.	name_declined_syntax	
^dev$	name_declined_developer	
developer	name_declined_developer
(-|')dev(-|')	name_declined_developer
^[ck][uv]+nt	name_declined_profane
"^[ck]o[ck]{1,3}"	name_declined_profane
^group$	name_declined_reserved
star.?wars	name_declined_fictionally_reserved
empire	name_declined_fictionally_reserved
divide	name_declined_fictionally_reserved
^ackbar$	name_declined_fictionally_reserved
^adega$	name_declined_fictionally_reserved
^agamar$	name_declined_fictionally_reserved
^alderaan$	name_declined_fictionally_reserved
^almania$	name_declined_fictionally_reserved
^almanian$	name_declined_fictionally_reserved
^alzoc$	name_declined_fictionally_reserved
^ambria$	name_declined_fictionally_reserved
^amedda$	name_declined_fictionally_reserved
^amidala$	name_declined_fictionally_reserved
^ammuud$	name_declined_fictionally_reserved
^ando$	name_declined_fictionally_reserved
^anoth$	name_declined_fictionally_reserved
^antar$	name_declined_fictionally_reserved
^aquaris$	name_declined_fictionally_reserved
^aridus$	name_declined_fictionally_reserved
^arkania$	name_declined_fictionally_reserved
^ass	name_declined_profane
^atat$	name_declined_fictionally_reserved
^athega$	name_declined_fictionally_reserved
^atst$	name_declined_fictionally_reserved
^atzerri$	name_declined_fictionally_reserved
^baas$	name_declined_fictionally_reserved
^badass$	name_declined_profane
^bagwa$	name_declined_fictionally_reserved
^bakura$	name_declined_fictionally_reserved
^balmorra$	name_declined_fictionally_reserved
^band$	name_declined_reserved
^bank$	name_declined_reserved
^barab$	name_declined_fictionally_reserved
^barada$	name_declined_fictionally_reserved
^belsavis$	name_declined_fictionally_reserved
^beshqek$	name_declined_fictionally_reserved
^bespin$	name_declined_fictionally_reserved
^bestine$	name_declined_fictionally_reserved
^bilbringi$	name_declined_fictionally_reserved
^bimmisaari$	name_declined_fictionally_reserved
^binks$	name_declined_fictionally_reserved
^blackmoon$	name_declined_fictionally_reserved	
^blue ?max$	name_declined_fictionally_reserved	1
^boba$	name_declined_fictionally_reserved	
^bollux$	name_declined_fictionally_reserved	
^bonadan$	name_declined_fictionally_reserved	
^borleais$	name_declined_fictionally_reserved	
^bossk$	name_declined_fictionally_reserved	
^both$	name_declined_fictionally_reserved	
^bothawui$	name_declined_fictionally_reserved	
^brakiss$	name_declined_fictionally_reserved	
^byss$	name_declined_fictionally_reserved	
^callista$	name_declined_fictionally_reserved	
^carida$	name_declined_fictionally_reserved	
^caridan$	name_declined_fictionally_reserved	
^carratos$	name_declined_fictionally_reserved	
^centerpoint$	name_declined_fictionally_reserved	
^chandrila$	name_declined_fictionally_reserved
^christ$	name_declined_reserved
^chume$	name_declined_fictionally_reserved
^circarpous$	name_declined_fictionally_reserved
^codru$	name_declined_fictionally_reserved
^corellia$	name_declined_fictionally_reserved
^corellian$	name_declined_fictionally_reserved
^coruscant$	name_declined_fictionally_reserved
^csr	name_declined_reserved
^cvetaen$	name_declined_fictionally_reserved
^cyax$	name_declined_fictionally_reserved
^dagobah$	name_declined_fictionally_reserved
^dantooine$	name_declined_fictionally_reserved
^darglum$	name_declined_fictionally_reserved
^dathomir$	name_declined_fictionally_reserved
^dellalt$	name_declined_fictionally_reserved
^dengar$	name_declined_fictionally_reserved
^dio$	name_declined_fictionally_reserved
^dios$	name_declined_fictionally_reserved
^djinn$	name_declined_fictionally_reserved
^djo$	name_declined_fictionally_reserved
^doornik$	name_declined_fictionally_reserved
^dorsk$	name_declined_fictionally_reserved
^dr.?evanzan$	name_declined_fictionally_reserved
^drall$	name_declined_fictionally_reserved
^driver$	name_declined_reserved
^drovian$	name_declined_fictionally_reserved
^duro$	name_declined_fictionally_reserved
^eisley$	name_declined_fictionally_reserved
^elder$	name_declined_reserved
^endor$	name_declined_fictionally_reserved
^eph[oa]ntm[oa]n$	name_declined_fictionally_reserved
^eriadu$	name_declined_fictionally_reserved
^espa$	name_declined_fictionally_reserved
^etti$	name_declined_fictionally_reserved
^evanzan$	name_declined_fictionally_reserved
^fac$	name_declined_fictionally_reserved
^fag$	name_declined_profane
^female$	name_declined_reserved
^fett$	name_declined_fictionally_reserved
^fey.?lya$	name_declined_fictionally_reserved
^fida$	name_declined_fictionally_reserved
^firrerre$	name_declined_fictionally_reserved
^fisto$	name_declined_fictionally_reserved
^flarestar$	name_declined_fictionally_reserved
^fondor$	name_declined_fictionally_reserved
^galantos$	name_declined_fictionally_reserved
^gall$	name_declined_fictionally_reserved
^gallandro$	name_declined_fictionally_reserved
^gallia$	name_declined_fictionally_reserved
^gamorr$	name_declined_fictionally_reserved
^garindan$	name_declined_fictionally_reserved
^garois$	name_declined_fictionally_reserved
^garos$	name_declined_fictionally_reserved
^gartogg$	name_declined_fictionally_reserved
^geonosis$	name_declined_fictionally_reserved
^gethzerion$	name_declined_fictionally_reserved
^god$	name_declined_reserved
^gondor$	name_declined_fictionally_reserved
^grand$	name_declined_reserved
^greedo$	name_declined_fictionally_reserved
^hapan$	name_declined_fictionally_reserved
^hapes$	name_declined_fictionally_reserved
^hethrir$	name_declined_fictionally_reserved
^hetnkik$	name_declined_fictionally_reserved
^hit$	name_declined_reserved
^hits$	name_declined_reserved
^homo$	name_declined_profane
^honoghr$	name_declined_fictionally_reserved
^horuset$	name_declined_fictionally_reserved
^hoth$	name_declined_fictionally_reserved
^ithor$	name_declined_fictionally_reserved
^jade$	name_declined_fictionally_reserved
^japrael$	name_declined_fictionally_reserved
^jesus$	name_declined_reserved
^jew$	name_declined_profane
^jin$	name_declined_fictionally_reserved
^jinn$	name_declined_fictionally_reserved
^ka$	name_declined_fictionally_reserved
^kabe$	name_declined_fictionally_reserved
^kaishicho$	name_declined_reserved
^kaisho$	name_declined_reserved
^kaisocho$	name_declined_reserved
^kalarba$	name_declined_fictionally_reserved
^kalsohono$	name_declined_reserved
^kamino$	name_declined_fictionally_reserved
^kashyyyk$	name_declined_fictionally_reserved
^kee$	name_declined_fictionally_reserved
^kessel$	name_declined_fictionally_reserved
^khabarakh$	name_declined_fictionally_reserved
^khomm$	name_declined_fictionally_reserved
^kile$	name_declined_fictionally_reserved
^kkhruk$	name_declined_fictionally_reserved
^kneesaa$	name_declined_fictionally_reserved
^koon$	name_declined_fictionally_reserved
^korriban$	name_declined_fictionally_reserved
^kosai$	name_declined_fictionally_reserved
^koth$	name_declined_fictionally_reserved
^kothlis$	name_declined_fictionally_reserved
^krayn$	name_declined_fictionally_reserved
^kuat$	name_declined_fictionally_reserved
^kumasi$	name_declined_fictionally_reserved
^kun$	name_declined_fictionally_reserved
^kushicho$	name_declined_reserved
^kusho$	name_declined_reserved
^kushoho$	name_declined_reserved
^kusocho$	name_declined_reserved
^labria$	name_declined_fictionally_reserved
^lady$	name_declined_reserved
^lars$	name_declined_fictionally_reserved
^lexidio$	name_declined_fictionally_reserved
^lobot$	name_declined_fictionally_reserved
^lom$	name_declined_fictionally_reserved
^lord$	name_declined_reserved
^lowbacca$	name_declined_fictionally_reserved
^lwhekk$	name_declined_fictionally_reserved
^lybeya$	name_declined_fictionally_reserved
^mace$	name_declined_fictionally_reserved
^male$	name_declined_reserved
^man$	name_declined_reserved
^mara$	name_declined_fictionally_reserved
^marr$	name_declined_fictionally_reserved
^maul$	name_declined_fictionally_reserved
^mennaalii$	name_declined_fictionally_reserved
^mimban$	name_declined_fictionally_reserved
^minister$	name_declined_reserved
^mirgoshir$	name_declined_fictionally_reserved
^miss$	name_declined_reserved
^misses$	name_declined_reserved
^moff$	name_declined_reserved
^mon$	name_declined_fictionally_reserved
^morobe$	name_declined_fictionally_reserved
^mrlsst$	name_declined_fictionally_reserved
^muftak$	name_declined_fictionally_reserved
^myrkr$	name_declined_fictionally_reserved
^mytus$	name_declined_fictionally_reserved
^n[-']?zoth$	name_declined_fictionally_reserved
^naboo$	name_declined_fictionally_reserved
^nevoota$	name_declined_fictionally_reserved
^nink$	name_declined_fictionally_reserved
^nkllon$	name_declined_fictionally_reserved
^nu$	name_declined_fictionally_reserved
^nudo$	name_declined_fictionally_reserved
^nunb$	name_declined_fictionally_reserved
^nym	name_declined_fictionally_reserved
^o[-']?pahz$	name_declined_fictionally_reserved
^offee$	name_declined_fictionally_reserved
^onderon$	name_declined_fictionally_reserved
^oola	name_declined_fictionally_reserved
^opoku$	name_declined_fictionally_reserved
^ord$	name_declined_fictionally_reserved
^ossus$	name_declined_fictionally_reserved
^ottega$	name_declined_fictionally_reserved
^paddie$	name_declined_fictionally_reserved
^padme$	name_declined_fictionally_reserved
^perave$	name_declined_fictionally_reserved
^piell$	name_declined_fictionally_reserved
^pilot$	name_declined_reserved
^plynn$	name_declined_fictionally_reserved
^poggle$	name_declined_fictionally_reserved
^polith$	name_declined_fictionally_reserved
^ponudo$	name_declined_fictionally_reserved
^poof$	name_declined_fictionally_reserved
"^pr[ie]{1,3}m[ie]{1,3}r$"	name_declined_reserved
^prime$	name_declined_reserved
^primeminister$	name_declined_reserved
^prindaar$	name_declined_fictionally_reserved
^pydyr$	name_declined_fictionally_reserved
^pyria$	name_declined_fictionally_reserved
^pzob$	name_declined_fictionally_reserved
^qwixux$	name_declined_fictionally_reserved
^rafa$	name_declined_fictionally_reserved
^ralltiir$	name_declined_fictionally_reserved
^rebo$	name_declined_fictionally_reserved
^rikuocho$	name_declined_reserved
^rikushicho$	name_declined_reserved
^rikushoho$	name_declined_reserved
^rillao$	name_declined_fictionally_reserved
^rodia$	name_declined_fictionally_reserved
^roon$	name_declined_fictionally_reserved
^rori$	name_declined_fictionally_reserved
^ryloth$	name_declined_fictionally_reserved
^saariha$	name_declined_fictionally_reserved
^sacorria$	name_declined_fictionally_reserved
^sacorrian$	name_declined_fictionally_reserved
^sai$	name_declined_fictionally_reserved
^sebulba	name_declined_fictionally_reserved
^selonia$	name_declined_fictionally_reserved
^serenno$	name_declined_fictionally_reserved
^sex$	name_declined_profane
^shmi$	name_declined_fictionally_reserved
^shug.?ninx$	name_declined_fictionally_reserved
^sing$	name_declined_fictionally_reserved	
^sir$	name_declined_reserved	
^siritachi$	name_declined_fictionally_reserved	
^sistooine$	name_declined_fictionally_reserved	
^sith$	name_declined_fictionally_reserved	
^sly$	name_declined_fictionally_reserved	
^slymoore$	name_declined_fictionally_reserved	
^smed$	name_declined_developer	
^ssi[-' ]?kaat$	name_declined_fictionally_reserved	1
^station$	name_declined_fictionally_reserved	
^sullust$	name_declined_fictionally_reserved	
^supi$	name_declined_fictionally_reserved	
^surric$	name_declined_fictionally_reserved	
^swan$	name_declined_fictionally_reserved	
^taanab$	name_declined_fictionally_reserved	
^tachi$	name_declined_fictionally_reserved	
^talasea$	name_declined_fictionally_reserved
^talus$	name_declined_fictionally_reserved
^tatoo$	name_declined_fictionally_reserved
^tatooine$	name_declined_fictionally_reserved
^tattoo$	name_declined_fictionally_reserved
^taun$	name_declined_fictionally_reserved
^taike$	name_declined_fictionally_reserved
^telti$	name_declined_fictionally_reserved
^tessek$	name_declined_fictionally_reserved
^teyr$	name_declined_fictionally_reserved
^thanas$	name_declined_fictionally_reserved
^the$	name_declined_reserved
^thee$	name_declined_reserved
^theenfida$	name_declined_fictionally_reserved
^thyferra$	name_declined_fictionally_reserved
^ti$	name_declined_fictionally_reserved
^tigris$	name_declined_fictionally_reserved
^tiin$	name_declined_fictionally_reserved
^tikkes$	name_declined_fictionally_reserved
^tionne$	name_declined_fictionally_reserved
^tit$	name_declined_profane
^tiure$	name_declined_fictionally_reserved
^tralus$	name_declined_fictionally_reserved
^trebor$	name_declined_fictionally_reserved
^triclops$	name_declined_fictionally_reserved
^tsuichoi$	name_declined_fictionally_reserved
^tynannni$	name_declined_fictionally_reserved
^tynna$	name_declined_fictionally_reserved
^typho$	name_declined_fictionally_reserved
^tyrius$	name_declined_fictionally_reserved
^umgul$	name_declined_fictionally_reserved
^unduli$	name_declined_fictionally_reserved
^utos$	name_declined_fictionally_reserved	
^vergesso$	name_declined_fictionally_reserved	
^vos$	name_declined_fictionally_reserved	
^watto$	name_declined_fictionally_reserved	
^wayland$	name_declined_fictionally_reserved	
^weequay$	name_declined_fictionally_reserved	
^woman$	name_declined_reserved	
^x[-' ]wing	name_declined_reserved	1
^y[-']?toub$	name_declined_fictionally_reserved	
^yaddle$	name_declined_fictionally_reserved	
^yavin$	name_declined_fictionally_reserved	
^ylesia$	name_declined_fictionally_reserved	
^zend$	name_declined_fictionally_reserved	
^zhar$	name_declined_fictionally_reserved	
^zuckuss$	name_declined_fictionally_reserved	
a.?[sz]hol	name_declined_profane	1
abregado.?rae	name_declined_fictionally_reserved	1
Achk.*Med.*Beq	name_declined_fictionally_reserved	1
acid	name_declined_profane	1
acy.?stapp	name_declined_developer	1
adi.?gallia	name_declined_fictionally_reserved	1
admiral	name_declined_reserved	1
adolf.?hitler	name_declined_reserved	1
aholic	name_declined_reserved	1
Aks.*Moe	name_declined_fictionally_reserved	1
alan.?pickett	name_declined_developer	1
aldar.?beedo	name_declined_fictionally_reserved	1
anakin	name_declined_fictionally_reserved	
Anakin	name_declined_fictionally_reserved	1
anal	name_declined_profane	1
Andi.*Gallia	name_declined_fictionally_reserved	1
andrew.?collins	name_declined_developer	1
angel	name_declined_reserved	1
anthony.?castoro	name_declined_developer	1
antilles$	name_declined_fictionally_reserved	
argente$	name_declined_fictionally_reserved	
Ark.*(Bumpy)?.*Roose	name_declined_fictionally_reserved	1
Ask.*Aak	name_declined_fictionally_reserved	1
aurra.?sing	name_declined_fictionally_reserved	1
austin.?appleby	name_declined_developer	1
Ayy.*Vida	name_declined_fictionally_reserved	1
balls	name_declined_profane	1
bastard	name_declined_profane
b[il]+tch	name_declined_profane	1
b[iy]teme	name_declined_profane	1
baoth$	name_declined_fictionally_reserved	
baron	name_declined_reserved	1
Barquin.*D.*an	name_declined_fictionally_reserved	1
barriss.?offee	name_declined_fictionally_reserved	1
beer	name_declined_reserved	1
beliblis$	name_declined_fictionally_reserved	
Ben.*Quadinaros	name_declined_fictionally_reserved	1
bernie.?la.?carte	name_declined_developer	1
beru.?lars	name_declined_fictionally_reserved	1
bill.?daly	name_declined_developer	1
billaba$	name_declined_fictionally_reserved	
bisexual	name_declined_profane
bismol	name_declined_reserved	
blowjob	name_declined_profane
bodo.?baas	name_declined_fictionally_reserved	1
Boles.*Roor	name_declined_fictionally_reserved	1
bomber	name_declined_reserved	1
boner	name_declined_profane	1
bong	name_declined_profane	1
boob	name_declined_profane	1
Borsk.*Fey.*lya	name_declined_fictionally_reserved	1
bothan	name_declined_fictionally_reserved	1
brad.?constantine	name_declined_developer	1
Brakiss	name_declined_fictionally_reserved	1
Bren.*Derlin	name_declined_fictionally_reserved	1
brigadier	name_declined_reserved	1
bright.?jewel	name_declined_fictionally_reserved	1
budweiser	name_declined_reserved
bukkake	name_declined_fictionally_reserved	
bultar.?swan	name_declined_fictionally_reserved	1
butt?ful	name_declined_profane	1
butthole	name_declined_profane
cadet	name_declined_reserved	1
calamari	name_declined_fictionally_reserved	1
calan.?thurow	name_declined_developer	1
calrisian$	name_declined_fictionally_reserved	
calrissian$	name_declined_fictionally_reserved	
cameltoe	name_declined_profane
captain	name_declined_reserved	1
captison$	name_declined_fictionally_reserved	
carlist.?rieekan	name_declined_fictionally_reserved	1
cha.?raaba	name_declined_fictionally_reserved	1
cekis$	name_declined_reserved
chancellor	name_declined_reserved	1
chew(ie|y)	name_declined_fictionally_reserved	1
chewbacca+	name_declined_fictionally_reserved	1
chief	name_declined_reserved	1
Chief.*Chirpa	name_declined_fictionally_reserved	1
chorios$	name_declined_fictionally_reserved	
chris.?douglas	name_declined_developer	1
chris.?mayer	name_declined_developer	1
christ	name_declined_reserved	
cinco.?barnes	name_declined_developer	1
Clegg.*Holdfast	name_declined_fictionally_reserved	1
clieggl.?lars	name_declined_fictionally_reserved	1
clit	name_declined_profane	1
clitoris	name_declined_profane
cocaine	name_declined_profane	1
coke	name_declined_profane	1
colonel	name_declined_reserved	1
commander	name_declined_reserved	1
commander	name_declined_reserved	1
commodore	name_declined_reserved	1
condom	name_declined_profane	1
Corde	name_declined_fictionally_reserved	1
corporal	name_declined_reserved	1
corran ?horn	name_declined_fictionally_reserved	1
count	name_declined_reserved	1
countess	name_declined_reserved	1
crack	name_declined_profane	1
crotch	name_declined_profane
cum	name_declined_profane	1
cybersex	name_declined_profane
da.?soocha	name_declined_fictionally_reserved	1
Daala	name_declined_fictionally_reserved	1
Dack.*Ralter	name_declined_fictionally_reserved	1
daemon	name_declined_reserved	1
damn	name_declined_profane	
damon.?waldrip	name_declined_developer	1
dan.?borth	name_declined_developer	1
dan.?rubenfield	name_declined_developer	1
darklighter$	name_declined_fictionally_reserved	
darth	name_declined_reserved	1
daryl.?sanders	name_declined_developer	1
dash.?rendar	name_declined_fictionally_reserved	1
deepthroat	name_declined_profane
demon	name_declined_reserved	1
denaria.?kee	name_declined_fictionally_reserved	1
deputy	name_declined_reserved	1
Derek.*Klivian	name_declined_fictionally_reserved	1
desilijic$	name_declined_fictionally_reserved	
devil	name_declined_reserved	1
devin.?lafontane	name_declined_developer	1
dick	name_declined_profane	
dictator	name_declined_reserved	1
dildo	name_declined_profane	1
director	name_declined_reserved	1
Doc	name_declined_fictionally_reserved	1
doctor.?evazan	name_declined_fictionally_reserved	1
Doda.*Bodonawieedo	name_declined_fictionally_reserved	1
dodanna$	name_declined_fictionally_reserved	
doggiestyle	name_declined_profane
don.?alexander	name_declined_developer	1
dong	name_declined_profane	
dooku	name_declined_fictionally_reserved	1
doole$	name_declined_fictionally_reserved	
Dorme	name_declined_fictionally_reserved	1
drovis$	name_declined_fictionally_reserved	
duchess	name_declined_reserved	1
Dud.*Bolt	name_declined_fictionally_reserved	1
durron$	name_declined_fictionally_reserved	
e.?bay	name_declined_reserved	1
e?(c|x)stac[eiy]	name_declined_profane	1
Ebe.*Endocott	name_declined_fictionally_reserved	1
Edcel.*Bar.*Gane	name_declined_fictionally_reserved	1
eeth ?koth	name_declined_fictionally_reserved	1
eigth	name_declined_reserved	1
Elan.*Sleazebaggano	name_declined_fictionally_reserved	1
ensign	name_declined_reserved	1
eric.?sebesta	name_declined_developer	1
eric.?simpson	name_declined_reserved	1
even.?piell	name_declined_fictionally_reserved	1
ewok	name_declined_fictionally_reserved	1
exar.?kun	name_declined_fictionally_reserved	1
f[uv]ck	name_declined_profane	1
faggot	name_declined_profane	1
fart	name_declined_profane	1
father	name_declined_reserved	1
Faytonni	name_declined_fictionally_reserved	1
felth$	name_declined_fictionally_reserved	
fetus	name_declined_reserved	1
fiend	name_declined_reserved	1
fifth	name_declined_reserved	1
fighter	name_declined_reserved	1
Finis	name_declined_fictionally_reserved	1
Fiolla	name_declined_fictionally_reserved	1
first	name_declined_reserved	1
fode.*beed	name_declined_fictionally_reserved	1
fondle	name_declined_profane	1
foreskin	name_declined_profane
fortuna$	name_declined_fictionally_reserved	
fourth	name_declined_reserved	1
gargan$	name_declined_fictionally_reserved	
Garindan	name_declined_fictionally_reserved	1
Garm.*Bel.*Iblis	name_declined_fictionally_reserved	1
Gasgano	name_declined_fictionally_reserved	1
general	name_declined_reserved	1
genital	name_declined_profane	1
gh?oober	name_declined_reserved	1
Ghent	name_declined_fictionally_reserved	1
Gilad.*Pellaeon	name_declined_fictionally_reserved	1
glenn.?snyder	name_declined_developer	1
gonad	name_declined_profane	1
governor	name_declined_reserved	1
Gragra	name_declined_fictionally_reserved	1
Grammel	name_declined_fictionally_reserved	1
grant.?mc.?daniel	name_declined_developer	1
Greeata	name_declined_fictionally_reserved	1
guard	name_declined_reserved	1
gungan	name_declined_fictionally_reserved	1
gunray$	name_declined_fictionally_reserved	
guybrush	name_declined_fictionally_reserved	
"h[aiy]+d+[aei]{1,3}n+.*b+l+a+[ck]+m+[aeiou]+n"	name_declined_developer	1
Halla	name_declined_fictionally_reserved	1
Han	name_declined_fictionally_reserved	1
hardon	name_declined_profane	1
hater	name_declined_profane	1
Hermi.*Odle	name_declined_fictionally_reserved	1
hitler	name_declined_reserved	
hooker	name_declined_profane	1
Horox.*Ryyder	name_declined_fictionally_reserved	1
human	name_declined_fictionally_reserved	1
hutt$	name_declined_fictionally_reserved	
hutta$	name_declined_fictionally_reserved	
Iaco.*Stark	name_declined_fictionally_reserved	1
idiot	name_declined_profane	1
imperial	name_declined_reserved	1
inquisitor	name_declined_reserved	1
interceptor	name_declined_reserved	1
ismaren$	name_declined_fictionally_reserved	
isolder$	name_declined_fictionally_reserved	
ister.?paddie	name_declined_fictionally_reserved	1
itto.?kaii	name_declined_reserved	1
itto.?kaisa	name_declined_reserved	1
itto.?kaishi	name_declined_reserved	1
itto.?kaisho	name_declined_reserved	1
itto.?kui	name_declined_reserved	1
itto.?kusa	name_declined_reserved	1
itto.?kushi	name_declined_reserved	1
itto.?kuso	name_declined_reserved	1
itto.?rikui	name_declined_reserved	1
itto.?rikusa	name_declined_reserved	1
itto.?rikushi	name_declined_reserved	1
itto.?rikuso	name_declined_reserved	1
j.?allen.?brack	name_declined_developer	1
j.?t.?p.?tan	name_declined_fictionally_reserved	1
j[ae]ng[ao]	name_declined_fictionally_reserved	1
j+a+r+.?j+a+r+	name_declined_fictionally_reserved	1
jabba	name_declined_fictionally_reserved	1
Jacen	name_declined_fictionally_reserved	1
Jaina	name_declined_fictionally_reserved	1
jake.?rodgers	name_declined_developer	1
james.?whisenant	name_declined_developer	1
Jamillia	name_declined_fictionally_reserved	1
jan.?dodonna	name_declined_fictionally_reserved	1
jar.?jar.?binks	name_declined_fictionally_reserved	1
jason.?minor	name_declined_developer	1
jason.?stone	name_declined_developer	1
jawa	name_declined_fictionally_reserved	1
Jaxxon	name_declined_fictionally_reserved	1
jedi	name_declined_reserved	1
jeff.?dobson	name_declined_developer	1
jeff.?freeman	name_declined_developer	1
jeff.?grills	name_declined_developer	1
jeff.?jonas	name_declined_developer	1
jeff.?sanders	name_declined_developer	1
jek.?porkins	name_declined_fictionally_reserved	1
jeremy.?jjiao	name_declined_developer	1
jeremy.?siprelle	name_declined_developer	1
Jerjerrod	name_declined_fictionally_reserved	1
jerriko$	name_declined_fictionally_reserved	
Jessa	name_declined_fictionally_reserved	1
jesus	name_declined_reserved	
jettster$	name_declined_fictionally_reserved	
Jira	name_declined_fictionally_reserved	1
jocasta.?nu	name_declined_fictionally_reserved	1
joe.?shoopack	name_declined_developer	1
joh.?yowza	name_declined_fictionally_reserved	1
joh?n.*roy	name_declined_developer	1
joh?n.?buzzolich	name_declined_developer	1
joh?n.?donham	name_declined_developer	1
joh?n.?guentzel	name_declined_developer	1
joh?n.?smedley	name_declined_developer	1
joh?n.?watson	name_declined_developer	1
Joruus.*C.*baoth	name_declined_fictionally_reserved	1
jose.?araiza	name_declined_developer	1
jun.?kai	name_declined_reserved	1
jun.?rikui	name_declined_reserved	1
junk.?mail	name_declined_reserved	1
justin.?randall	name_declined_developer	1
kaarde$	name_declined_fictionally_reserved	
kaijo.?bakuryocho	name_declined_reserved	1
katarn$	name_declined_fictionally_reserved	
kendal.?ozzel	name_declined_fictionally_reserved	1
kenobi$	name_declined_fictionally_reserved	
Ketwol	name_declined_fictionally_reserved	1
kevin.?o.?hara	name_declined_developer	1
Ki.*Adi.*Mundi	name_declined_fictionally_reserved	1
kia.?di.?mundi	name_declined_fictionally_reserved	1
kike	name_declined_profane	1
killer	name_declined_reserved	1
k.?mart	name_declined_reserved	1
king	name_declined_reserved	1
Kir.*Kanos	name_declined_fictionally_reserved	1
kit.?fisto	name_declined_fictionally_reserved	1
Kitik.*Keek.*kak	name_declined_fictionally_reserved	1
Kitster	name_declined_fictionally_reserved	1
kkk	name_declined_profane	1
klu.?klux.?klan	name_declined_profane	1
knight	name_declined_reserved	1
koku.?bakuryocho	name_declined_reserved	1
Komari.*Vosa	name_declined_fictionally_reserved	1
kouhuns$	name_declined_fictionally_reserved	
kris.?taylor	name_declined_developer	1
labia	name_declined_profane	1
laden	name_declined_reserved	
Lama.*Su	name_declined_fictionally_reserved	1
lapdance	name_declined_profane
Leia	name_declined_fictionally_reserved	1
lesbian	name_declined_profane
lezbo	name_declined_profane	1
libkath$	name_declined_fictionally_reserved	
licker	name_declined_profane
lieutenant	name_declined_reserved	1
Logray	name_declined_fictionally_reserved	1
lolita	name_declined_profane	1
Lorth.*Needa	name_declined_fictionally_reserved	1
loser	name_declined_profane	1
lotion	name_declined_profane	1
Lott.*Dod	name_declined_fictionally_reserved	1
lowlife	name_declined_profane	1
luminara.?unduli	name_declined_fictionally_reserved	1
Lumiya	name_declined_fictionally_reserved	1
m['-]?haeli	name_declined_fictionally_reserved	1
madame	name_declined_reserved	1
madine$	name_declined_fictionally_reserved	
major	name_declined_reserved	1
mara.?jade	name_declined_fictionally_reserved	1
Mars.*Guo	name_declined_fictionally_reserved	1
mas.?amedda	name_declined_fictionally_reserved	1
master	name_declined_reserved	1
matt.?bogue	name_declined_developer	1
matt.?higby	name_declined_developer	1
matt.?kwid	name_declined_developer	1
Mawhonic	name_declined_fictionally_reserved	1
max.?rebo	name_declined_fictionally_reserved	1
maximillian.?veers	name_declined_fictionally_reserved	1
mayor	name_declined_reserved	1
mccool$	name_declined_fictionally_reserved	
Melas	name_declined_fictionally_reserved	1
microsoft	name_declined_reserved
minoh.?kim	name_declined_developer	1
molest	name_declined_profane
moneyshot	name_declined_profane
Momaw.*Nadon	name_declined_fictionally_reserved	1
mother	name_declined_reserved	1
mothma$	name_declined_fictionally_reserved	
muff	name_declined_profane	1
muncher	name_declined_profane	1
munto.?codru	name_declined_fictionally_reserved	1
naberrie$	name_declined_fictionally_reserved	
nazi	name_declined_profane	1
negro	name_declined_profane	1
nick.?zuccarello	name_declined_developer	1
nien.?nunb	name_declined_fictionally_reserved	1
nigg?er	name_declined_profane	1
nigga	name_declined_profane	1
nineth	name_declined_reserved	1
nitto.?kaii	name_declined_reserved	1
nitto.?kaisa	name_declined_reserved	1
nitto.?kaishi	name_declined_reserved	1
nitto.?kaisho	name_declined_reserved	1
nitto.?kui	name_declined_reserved	1
nitto.?kusa	name_declined_reserved	1
nitto.?kushi	name_declined_reserved	1
nitto.?kuso	name_declined_reserved	1
nitto.?rikui	name_declined_reserved	1
nitto.?rikusa	name_declined_reserved	1
nitto.?rikushi	name_declined_reserved	1
nitto.?rikuso	name_declined_reserved	1
nookie	name_declined_profane	1
nude	name_declined_profane	1
Nyrat.*Agira	name_declined_fictionally_reserved	1
o.?cum	name_declined_profane	1
obi[-' ]?wan	name_declined_fictionally_reserved	1
Odumin	name_declined_fictionally_reserved	1
Ody.*Mandrell	name_declined_fictionally_reserved	1
officer	name_declined_reserved	1
Onaconda.*Farr	name_declined_fictionally_reserved	1
ord.?mantell	name_declined_fictionally_reserved	1
organa$	name_declined_fictionally_reserved	
orgasm	name_declined_profane
Orn.*Free.*Taa	name_declined_fictionally_reserved	1
Orrimaarko	name_declined_fictionally_reserved	1
osama	name_declined_reserved	
osama.?bin.?laden	name_declined_reserved	1
owen.?lars	name_declined_fictionally_reserved	1
p[iy]mp	name_declined_profane	1
pablo.?jill	name_declined_fictionally_reserved	1
padawan	name_declined_reserved	1
pallaeon$	name_declined_fictionally_reserved	
palpatine	name_declined_fictionally_reserved	1
Panaka	name_declined_fictionally_reserved	1
Paploo	name_declined_fictionally_reserved	1
pecker	name_declined_profane	1
penis	name_declined_profane	
pepto	name_declined_reserved	
period	name_declined_profane	1
Piett	name_declined_fictionally_reserved	1
pisshead	name_declined_profane
playboy	name_declined_reserved
plo.?koon	name_declined_fictionally_reserved	1
ponda ?baba	name_declined_fictionally_reserved	1
ponda.?baba	name_declined_fictionally_reserved	1
poon	name_declined_profane	1
poop	name_declined_profane	1
porn	name_declined_profane	1
pot	name_declined_profane	1
president	name_declined_reserved	1
prick	name_declined_profane	
prince	name_declined_reserved	1
private	name_declined_reserved	1
prostitute	name_declined_profane
pubic	name_declined_profane	1
pussy	name_declined_profane	1
qeldroma$	name_declined_fictionally_reserved	
queef	name_declined_profane	1
queen	name_declined_reserved	1
queer	name_declined_profane	1
Qui.*Gon.*Jinn	name_declined_fictionally_reserved	1
qui[-' ]?gon	name_declined_fictionally_reserved	1
raider	name_declined_reserved	1
rancisis$	name_declined_fictionally_reserved	
rape	name_declined_profane	1
Rappertunie	name_declined_fictionally_reserved	1
Ratts.*Tyerell	name_declined_fictionally_reserved	1
rebel	name_declined_reserved	1
rectum	name_declined_profane
Red.*Leader	name_declined_fictionally_reserved	1
ree.?yees	name_declined_fictionally_reserved	1
reece.?thornton	name_declined_developer	1
Rekkon	name_declined_fictionally_reserved	1
Rep.*Been	name_declined_fictionally_reserved	1
Rep.*Teers	name_declined_fictionally_reserved	1
retard	name_declined_profane
Reti	name_declined_fictionally_reserved	1
rh?a+l?[phf].*[ck]+o+[sz]+t+[aeiou]+r	name_declined_developer	1
Ric.*Olie	name_declined_fictionally_reserved	1
ric.*vogel	name_declined_developer	1
rick.?delashmit	name_declined_developer	1
rikujo.?bakuryocho	name_declined_reserved	1
rimjob	name_declined_profane
rob.?cuenca	name_declined_developer	1
rodian	name_declined_fictionally_reserved	1
Ronet.*Coorr	name_declined_fictionally_reserved	1
royal	name_declined_reserved	1
rune.?haako	name_declined_fictionally_reserved	1
ryan.?bond	name_declined_developer	1
ryan.?palacio	name_declined_developer	1
Rystall	name_declined_fictionally_reserved	1
s(ph|f)in(c|ch|ck|k)t	name_declined_profane	1
saari ha	name_declined_fictionally_reserved	1
Sabe	name_declined_fictionally_reserved	1
Saelt.*Marae	name_declined_fictionally_reserved	1
saesee ?tiin	name_declined_fictionally_reserved	1
Sagoro.*Autem	name_declined_fictionally_reserved	1
salacious.?crumb	name_declined_fictionally_reserved	1
salacious.?crumb	name_declined_fictionally_reserved	1
salim.?grant	name_declined_developer	1
salla.?zend	name_declined_fictionally_reserved	1
san.?hill	name_declined_fictionally_reserved	1
santo.?kaii	name_declined_reserved	1
santo.?kaisa	name_declined_reserved	1
santo.?kaishi	name_declined_reserved	1
santo.?kaiso	name_declined_reserved	1
santo.?kui	name_declined_reserved	1
santo.?kusa	name_declined_reserved	1
santo.?kushi	name_declined_reserved	1
santo.?kuso	name_declined_reserved	1
santo.?rikui	name_declined_reserved	1
santo.?rikusa	name_declined_reserved	1
santo.?rikushi	name_declined_reserved	1
santo.?rikuso	name_declined_reserved	1
sarge	name_declined_reserved	1
satan	name_declined_reserved	1
schlong	name_declined_profane	1
screw	name_declined_profane	1
scrotu	name_declined_profane	1
second	name_declined_reserved	1
secura$	name_declined_fictionally_reserved	
Sei.*Taria	name_declined_fictionally_reserved	1
semen	name_declined_profane	1
Sena.*Leikvold.*Midanyl	name_declined_fictionally_reserved	1
senator	name_declined_reserved	1
senior	name_declined_reserved	1
sergeant	name_declined_reserved	1
seventh	name_declined_reserved	1
sh[ai]t	name_declined_profane	1
shaak.?ti	name_declined_fictionally_reserved	1
shaddaa$	name_declined_fictionally_reserved	
shag	name_declined_profane	1
sheriff	name_declined_reserved	1
shu.?mai	name_declined_fictionally_reserved	1
shug.?ninx	name_declined_fictionally_reserved	1
sibwarra$	name_declined_fictionally_reserved	
Sio.*Bibble	name_declined_fictionally_reserved	1
^sith$	name_declined_fictionally_reserved	
sivrak$	name_declined_fictionally_reserved	
sixth	name_declined_reserved	1
skank	name_declined_profane	1
skywalker$	name_declined_fictionally_reserved	
slime	name_declined_profane	1
slut	name_declined_profane	
smoke	name_declined_reserved	1
snootles$	name_declined_fictionally_reserved	
sodomy	name_declined_profane
soe.?customerservice	name_declined_reserved	1
soldier	name_declined_reserved	1
solo$	name_declined_fictionally_reserved	
sperm	name_declined_profane	1
spick	name_declined_profane	1
spince$	name_declined_fictionally_reserved	
spit	name_declined_profane	1
stassallie	name_declined_fictionally_reserved	1
steve.?jakab	name_declined_developer	1
strapon	name_declined_profane	1
suck	name_declined_profane	1
suicide	name_declined_profane
sun.?fac	name_declined_fictionally_reserved	1
sunrider$	name_declined_fictionally_reserved	
Supreme.*Valorum	name_declined_fictionally_reserved	1
system	name_declined_developer	1
taa.?chume	name_declined_fictionally_reserved	1
taco.?bell	name_declined_reserved	1
Tagge	name_declined_fictionally_reserved	1
Talon.*Karrde	name_declined_fictionally_reserved	1
tampon	name_declined_profane	1
tarkin$	name_declined_fictionally_reserved	
Tarpals	name_declined_fictionally_reserved	1
taun ?we	name_declined_fictionally_reserved	1
Teemto.*Pagalies	name_declined_fictionally_reserved	1
ten.?tempests	name_declined_fictionally_reserved	1
tenth	name_declined_reserved	1
testicle	name_declined_profane
third	name_declined_reserved	1
thrawn$	name_declined_fictionally_reserved	
threep	name_declined_fictionally_reserved	
tim.?webb	name_declined_developer	1
tits	name_declined_profane	1
todd.?bailey	name_declined_developer	1
todd.?fiala	name_declined_developer	1
toilet	name_declined_profane
tonnika$	name_declined_fictionally_reserved	
tony.?rado	name_declined_developer	1
Toonbuck.*Toora	name_declined_fictionally_reserved	1
Toryn.*Farr	name_declined_fictionally_reserved	1
towani$	name_declined_fictionally_reserved	
tramp	name_declined_profane	1
trandoshan	name_declined_fictionally_reserved	1
trooper	name_declined_reserved	1
Tru.*Veld	name_declined_fictionally_reserved	1
Tsavong.*Lah	name_declined_fictionally_reserved	1
Tundra.*Dowmeia	name_declined_fictionally_reserved	1
turd	name_declined_profane	1
tusken	name_declined_fictionally_reserved	1
twi.?lek	name_declined_fictionally_reserved	1
tyrannus	name_declined_fictionally_reserved	1
Umpass.*stay	name_declined_fictionally_reserved	1
urinate	name_declined_profane	1
vader	name_declined_fictionally_reserved	1
vagina	name_declined_profane	
valarian$	name_declined_fictionally_reserved	
Vergere	name_declined_fictionally_reserved	1
vibrator	name_declined_profane	1
Vilmarh.*Grahrk	name_declined_fictionally_reserved	1
vima.?da.?boda	name_declined_fictionally_reserved	1
virgin	name_declined_profane	1
w?[hj]ore	name_declined_profane	1
Wald	name_declined_fictionally_reserved	1
wal.?mart	name_declined_reserved	1
Wan.*Sandage	name_declined_fictionally_reserved	1
warrick$	name_declined_fictionally_reserved	
Wat.*Tambor	name_declined_fictionally_reserved	1
Wes.*Janson	name_declined_fictionally_reserved	1
wessell$	name_declined_fictionally_reserved	
whacker	name_declined_profane	1
Wicket.*W.*Warrick	name_declined_fictionally_reserved	1
wigger	name_declined_profane	1
will.?kier	name_declined_developer	1
william.?wallace	name_declined_developer	1
windu	name_declined_fictionally_reserved	1
Winter	name_declined_fictionally_reserved	1
wookiee	name_declined_fictionally_reserved	1
Wuher	name_declined_fictionally_reserved	1
Xizor	name_declined_fictionally_reserved	1
xxx	name_declined_profane
yarael ?poof	name_declined_fictionally_reserved	1
yoda	name_declined_fictionally_reserved	1
Ysanne.*Isard	name_declined_fictionally_reserved	1
zabrak	name_declined_fictionally_reserved	1
Zam.*Wessel	name_declined_fictionally_reserved	1
Zev.*Senesca	name_declined_fictionally_reserved	1
s[l1]+[a4]+v[e3]	name_declined_fictionally_reserved	1
m[il1']+[e3]+n+[il1']+u+m+.*[fp]+[h]*[a4]+[l1]+[ck]+[o0u]+n*	name_declined_fictionally_reserved	1
(-|')gm(-|')	name_declined_reserved	
^gm(-|')	name_declined_reserved	
(-|')gm$	name_declined_reserved	
^soe$	name_declined_reserved	
(-|')soe(-|')	name_declined_reserved	
^soe(-|')	name_declined_reserved	
(-|')soe$	name_declined_reserved	
^dev(-|')	name_declined_reserved	
(-|')dev$	name_declined_reserved	
csr	name_declined_reserved	
producer	name_declined_reserved	
designer	name_declined_reserved	
