component	engine
s	s
collection_reward_booster_01_mk1	
collection_reward_booster_01_mk2	
collection_reward_booster_01_mk3	
collection_reward_booster_01_mk4	
collection_reward_booster_01_mk5	
bst_corellian_advanced_thrust_enhancer	
bst_corellian_elite_thrust_enhancer	
bst_corellian_experimental_tjh3	
bst_corellian_heavy_thrust_enhancer	
bst_corellian_highly_modified_elite_thrust_enhancer	
bst_corellian_performance_advanced_thrust_enhancer	
bst_corellian_promotional_standard_thrust_enhancer	
bst_corellian_standard_thrust_enhancer	
bst_corellian_tjh3	
bst_corellian_tuned_heavy_thrust_enhancer	
bst_cygnus_flashboost3	
bst_cygnus_flashboost4	
bst_elite_booster	
bst_freitek_outrunner_x1	
bst_gallofree_light	
bst_generic	
bst_incom_deluxe_fynock	
bst_incom_elite_sls_1	
bst_incom_enhanced_mynock	
bst_incom_fynock	
bst_incom_intimidator_mk1	
bst_incom_intimidator_mk2	
bst_incom_intimidator_mk3	
bst_incom_intimidator_mk4	
bst_incom_mynock	
bst_incom_nkj31	
bst_incom_performance_nkj31	
bst_incom_sls_1	
bst_incom_supercharged_vynock	
bst_incom_vynock	
bst_kde_br12	
bst_kessel_imperial_cygnus_hyperthrust	
bst_kessel_imperial_sds_experimental_b7	
bst_kessel_imperial_sfs_ultra_thrust	
bst_kessel_rebel_incom_quicksilver	
bst_kessel_rebel_incom_windrunner	
bst_kessel_rebel_mandal_lightning_m1	
bst_koensayr_advanced	
bst_koensayr_charged_advanced	
bst_koensayr_deluxe_elite	
bst_koensayr_elite	
bst_koensayr_evh12	
bst_koensayr_heavy	
bst_koensayr_modified_heavy	
bst_koensayr_racer_mk1	
bst_koensayr_racer_mk2	
bst_koensayr_racer_mk3	
bst_koensayr_racer_mk4	
bst_koensayr_special_evh12	
bst_koensayr_improved_standard	
bst_koensayr_standard	
bst_kse_als_1	
bst_kse_bti1	
bst_kse_bti2	
bst_kse_bti3	
bst_kse_cb6	
bst_kse_deluxe_bti3	
bst_kse_elite_als_1	
bst_kse_enhanced_bti2	
bst_kse_performance_bti1	
bst_kse_performance_cb6	
bst_kuat_military_mk1	
bst_kuat_military_mk2	
bst_kuat_military_mk3	
bst_kuat_military_mk4	
bst_mandal_deluxe_jbj_mk4	
bst_mandal_enhanced_jbj_mk1	
bst_mandal_improved_jbj_mk3	
bst_mandal_jbj_mk1	
bst_mandal_jbj_mk2	
bst_mandal_jbj_mk3	
bst_mandal_jbj_mk4	
bst_mandal_jbj_mk5	
bst_mandal_limited_jbj_mk5	
bst_mandal_modified_jbj_mk2	
bst_mission_reward_imperial_rss_ion_booster	
bst_mission_reward_neutral_mandal_m_series	
bst_mission_reward_neutral_mandal_q_series	
bst_mission_reward_rebel_novaldex_hypernova	
bst_mission_reward_rebel_qualdex_halcyon	
bst_mk1	
bst_mk2	
bst_mk3	
bst_mk4	
bst_mk5	
bst_moncal_advanced	
bst_moncal_charged_heavy	
bst_moncal_deluxe_standard	
bst_moncal_elite	
bst_moncal_enhanced_elite	
bst_moncal_heavy	
bst_moncal_jlc37	
bst_moncal_limited_jlc37	
bst_moncal_rare_advanced	
bst_moncal_standard	
bst_nova_breaker	
bst_novaldex_pulsar	
bst_novaldex_pulsar_advanced	
bst_novaldex_quasar	
bst_novaldex_quasar_advanced	
bst_qualdex_xboost_mk1	
bst_qualdex_xboost_mk2	
bst_qualdex_xboost_mk3	
bst_qualdex_xboost_mk4	
bst_reward_incom_elite	
bst_reward_koensayr_elite	
bst_reward_kuat_elite	
bst_reward_novaldex_elite	
bst_reward_qualdex_elite	
bst_rss_special	
bst_sap_imperial_1	
bst_sap_imperial_2	
bst_sds_enhanced_imperial_2	
bst_sfs_imperial_1	
bst_sfs_imperial_2	
bst_slayn_ion_booster_mk1	
bst_sorosuub_enhanced_liberator_mk4	
bst_sorosuub_improved_liberator_mk2	
bst_sorosuub_liberator_mk1	
bst_sorosuub_liberator_mk2	
bst_sorosuub_liberator_mk3	
bst_sorosuub_liberator_mk4	
bst_sorosuub_liberator_mk5	
bst_sorosuub_prized_liberator_mk1	
bst_sorosuub_supercharged_liberator_mk3	
bst_sorosuub_well_tuned_liberator_mk5	
bst_subpro_accelatron_mk1	
bst_subpro_accelatron_mk2	
bst_subpro_accelatron_mk3	
bst_subpro_accelatron_mk4	
bst_subpro_accelatron_mk5	
bst_subpro_deluxe_accelatron_mk3	
bst_subpro_elite_accelatron_mk5	
bst_subpro_enhanced_accelatron_mk2	
bst_subpro_modified_accelatron_mk4	
bst_subpro_tuned_accelatron_mk1	
bst_surronian_accelerator_mk1	
bst_surronian_accelerator_mk2	
bst_surronian_nomad_x4	
bst_surronian_nomad_x8	
bst_tiefighter_basic	
bst_xwing_booster_s01	
bst_z95_basic	
eng_bezelbok_kessel_runner	twing_engine_01:attach1
eng_corellian_cruiser_grade_mk1	twing_engine_02:attach1
eng_corellian_cruiser_grade_mk2	twing_engine_02:attach1
eng_corellian_deluxe_cruiser_grade_mk1	twing_engine_02:attach1
eng_crafted_incom_fusialthrust	twing_engine_01:attach1
eng_crafted_novaldex_eventhorizon	twing_engine_02:attach1
eng_crafted_qualdex_kyromaster	twing_engine_02:attach1
eng_cygnus_hd3	twing_engine_02:attach1
eng_cygnus_hd7	twing_engine_02:attach1
eng_cygnus_hd8	twing_engine_02:attach1
eng_cygnus_hd_5	twing_engine_02:attach1
eng_cygnus_hdx	twing_engine_02:attach1
eng_damorian_rx7	twing_engine_02:attach1
eng_freitek_dual_jet	twing_engine_02:attach1
eng_gallofree_advanced	twing_engine_02:attach1
eng_gallofree_jx2	twing_engine_02:attach1
eng_gallofree_jx3	twing_engine_02:attach1
eng_generic	twing_engine_02:attach1
eng_h17_singularity	twing_engine_01:attach1
eng_haor_chall_old_engine	twing_engine_01:attach1
eng_incom_advanced	twing_engine_02:attach1
eng_incom_advanced_fusialthrust	twing_engine_02:attach1
eng_incom_e16	twing_engine_02:attach1
eng_incom_elite	twing_engine_02:attach1
eng_incom_fusialthrust	twing_engine_02:attach1
eng_incom_fusialthrust_2	twing_engine_02:attach1
eng_incom_heavy_fusialthrust	twing_engine_02:attach1
eng_incom_improved_fusialthrust_2	twing_engine_02:attach1
eng_incom_light_fusialthrust	twing_engine_02:attach1
eng_koensayr_advanced	twing_engine_01:attach1
eng_koensayr_dual_small_ionjet	twing_engine_02:attach1
eng_koensayr_elite	twing_engine_02:attach1
eng_koensayr_enhanced_dual_small_ionjet	twing_engine_02:attach1
eng_koensayr_heavy_ionjet	twing_engine_02:attach1
eng_koensayr_ionjet	twing_engine_02:attach1
eng_koensayr_small_ionjet	twing_engine_02:attach1
eng_koensayr_tuned_small_ionjet	twing_engine_02:attach1
eng_kongar_defender	twing_engine_02:attach1
eng_kse_a2x	twing_engine_02:attach1
eng_kse_a5x	twing_engine_02:attach1
eng_kse_a7x	twing_engine_01:attach1
eng_kse_a8x	twing_engine_02:attach1
eng_kse_advanced	twing_engine_02:attach1
eng_kse_elite	twing_engine_02:attach1
eng_kse_improved_a2x	twing_engine_02:attach1
eng_kuat_a9x	twing_engine_02:attach1
eng_kuat_f31	twing_engine_02:attach1
eng_kuat_tc40	twing_engine_01:attach1
eng_mandal_advanced	twing_engine_02:attach1
eng_mandal_elite	twing_engine_02:attach1
eng_mandal_enhanced_heavy	twing_engine_02:attach1
eng_mandal_firestorm	twing_engine_02:attach1
eng_mandal_firestorm_2	twing_engine_02:attach1
eng_mandal_heavy	twing_engine_02:attach1
eng_mandal_x37_vandal	twing_engine_02:attach1
eng_mandal_x57_vandal	twing_engine_02:attach1
eng_mission_reward_imperial_cygnus_megadrive	twing_engine_01:attach1
eng_mission_reward_neutral_haor_chall_military	twing_engine_01:attach1
eng_mission_reward_neutral_mandal_inferno	twing_engine_01:attach1
eng_mission_reward_rebel_incom_military	twing_engine_01:attach1
eng_mk1	twing_engine_02:attach1
eng_mk2	twing_engine_02:attach1
eng_mk3	twing_engine_02:attach1
eng_mk4	twing_engine_02:attach1
eng_mk5	twing_engine_02:attach1
eng_moncal_charged_standard	twing_engine_02:attach1
eng_moncal_enhanced_light	twing_engine_02:attach1
eng_moncal_heavy	twing_engine_01:attach1
eng_moncal_ifs32	twing_engine_02:attach1
eng_moncal_ifs64	twing_engine_02:attach1
eng_moncal_improved_heavy	twing_engine_02:attach1
eng_moncal_light	twing_engine_02:attach1
eng_moncal_standard	twing_engine_02:attach1
eng_novaldex_advanced	twing_engine_02:attach1
eng_novaldex_eventhorizon	twing_engine_02:attach1
eng_novaldex_light_eventhorizon	twing_engine_02:attach1
eng_novaldex_singularity	twing_engine_01:attach1
eng_novaldex_x12	twing_engine_02:attach1
eng_novaldex_x6	twing_engine_02:attach1
eng_novaldex_x7	twing_engine_02:attach1
eng_novaldex_x9	twing_engine_02:attach1
eng_nubian_221	twing_engine_02:attach1
eng_nubian_221_racing_mod	twing_engine_02:attach1
eng_prototype	twing_engine_02:attach1
eng_qualdex_a10	twing_engine_02:attach1
eng_qualdex_a13	twing_engine_02:attach1
eng_qualdex_advanced	twing_engine_02:attach1
eng_qualdex_b10	twing_engine_02:attach1
eng_qualdex_elite	twing_engine_02:attach1
eng_qualdex_igt	twing_engine_02:attach1
eng_qualdex_kyromaster	twing_engine_02:attach1
eng_qualdex_small_kyromaster	twing_engine_02:attach1
eng_quantum_ion_drive	twing_engine_02:attach1
eng_rendili_demon_mk1	twing_engine_02:attach1
eng_rendili_elite	twing_engine_02:attach1
eng_rss_advanced	twing_engine_02:attach1
eng_rss_elite	twing_engine_02:attach1
eng_rss_imperial_skyrunner	twing_engine_01:attach1
eng_rss_imperial_skyrunner_2	twing_engine_02:attach1
eng_rss_imperial_skyrunner_3	twing_engine_02:attach1
eng_rss_imperial_skyrunner_4	twing_engine_02:attach1
eng_sds_imperial_1	twing_engine_02:attach1
eng_sds_imperial_2	twing_engine_02:attach1
eng_sds_limited_imperial_1	twing_engine_02:attach1
eng_seinar_ps56	twing_engine_02:attach1
eng_sfs_advanced	twing_engine_02:attach1
eng_sfs_elite	twing_engine_02:attach1
eng_sfs_imperial_1	twing_engine_02:attach1
eng_sfs_imperial_2	twing_engine_02:attach1
eng_sfs_imperial_3	twing_engine_01:attach1
eng_sfs_imperial_4	twing_engine_02:attach1
eng_sfs_imperial_5	twing_engine_02:attach1
eng_sfs_modified_imperial_3	twing_engine_02:attach1
eng_sfs_performance_imperial_1	twing_engine_02:attach1
eng_sfs_tuned_imperial_2	twing_engine_02:attach1
eng_sorosuub_l_337_ion_engine	twing_engine_02:attach1
eng_sorosuub_tuned_l_337_ion_engine	twing_engine_02:attach1
eng_sorosuub_u83r_ion_drive	twing_engine_02:attach1
eng_subpro_light_engines	twing_engine_02:attach1
eng_surronian_a2	twing_engine_02:attach1
eng_surronian_a25	twing_engine_02:attach1
eng_ubrikkian_n2	twing_engine_01:attach1
eng_kessel_imperial_rendili_hyperion_drive	twing_engine_02:attach1
eng_kessel_imperial_sds_special_forces	twing_engine_02:attach1
eng_kessel_imperial_sfs_special_forces	twing_engine_02:attach1
eng_kessel_rebel_incom_t11_elite	twing_engine_02:attach1
eng_kessel_rebel_novaldex_blackhole_elite	twing_engine_02:attach1
eng_kessel_rebel_novaldex_grb1138	twing_engine_02:attach1
eng_reward_kuat_elite	twing_engine_02:attach1
eng_nova_01	twing_engine_02:attach1
eng_orion_01	twing_engine_01:attach1
collection_reward_engine_01_mk1	twing_engine_02:attach1
collection_reward_engine_01_mk2	twing_engine_02:attach1
collection_reward_engine_01_mk3	twing_engine_02:attach1
collection_reward_engine_01_mk4	twing_engine_02:attach1
collection_reward_engine_01_mk5	twing_engine_02:attach1
eng_t86_shooting_star	twing_engine_02:attach1
eng_kuat_m24	twing_engine_02:attach1
eng_kuat_experimental	twing_engine_01:attach1
eng_reward_experimental	twing_engine_01:attach1
wpn_advanced_blaster	
wpn_advanced_blaster_green	
wpn_advanced_disruptor	
wpn_advanced_ioncannon	
wpn_armek_advanced	
wpn_armek_elite	
wpn_armek_sw4	
wpn_armek_sw6	
wpn_armek_sw7	
wpn_armek_sw8	
wpn_awing_blaster	
wpn_borstel_rg9	
wpn_bwing_blaster	
wpn_corellian_1d	
wpn_corellian_ag1g_laser	
wpn_corellian_ag2g_quad_laser	
wpn_corellian_cruiser_grade_blaster_mk1	
wpn_corellian_heavy_gauss	
wpn_crafted_incom_disruptor	
wpn_crafted_slayn_ioncannon	
wpn_crafted_subpro_tripleblaster	
wpn_crafted_tractor_beam	
wpn_cygnus_destroyer_mk1	
wpn_cygnus_destroyer_mk2	
wpn_cygnus_elite	
wpn_cygnus_eradicator_1	
wpn_experimental_blaster	
wpn_experimental_blaster_green	
wpn_experimental_disruptor	
wpn_experimental_ioncannon	
wpn_fastspray_2000_disruptor	
wpn_freitek_cannoneer_mk1	
wpn_gyrhil_auto_blaster	
wpn_gyrhil_r9x	
wpn_haor_chall_speedblaster	
wpn_heavy_blaster	
wpn_heavy_blaster_green	
wpn_heavy_disruptor	
wpn_heavy_ioncannon	
wpn_hk_modified_scorcher_elite	
wpn_hk_scorcher	
wpn_hk_scorcher_2	
wpn_hk_scorcher_3	
wpn_hk_scorcher_advanced	
wpn_hk_scorcher_elite	
wpn_hk_scorcher_heavy	
wpn_hoersch_railgun	
wpn_incom_advanced_blaster	
wpn_incom_blaster	
wpn_incom_disruptor	
wpn_incom_elite_quad_blaster	
wpn_incom_heavy_blaster	
wpn_incom_heavy_quad_blaster	
wpn_incom_light_blaster	
wpn_incom_quad_blaster	
wpn_incom_shredder	
wpn_incom_tt13	
wpn_incom_tt8	
wpn_kdy_pounder_mk1	
wpn_koensayr_deluxe_ion_accelerator	
wpn_koensayr_ion_accelerator	
wpn_koensayr_ion_accelerator_2	
wpn_koensayr_ion_accelerator_3	
wpn_koensayr_ion_accelerator_advanced	
wpn_koensayr_light_disruptor	
wpn_koensayr_tuned_light_disruptor	
wpn_kse_double_blaster	
wpn_kse_light_disruptor	
wpn_laser_beam_gun	
wpn_light_blaster	
wpn_light_blaster_green	
wpn_light_disruptor	
wpn_light_ioncannon	
wpn_mandal_advanced_annihilator	
wpn_mandal_annihilator_mk2	
wpn_mandal_annilhator_mk1	
wpn_mandal_elite_annihilator	
wpn_mandal_enhanced_mangler_mk1	
wpn_mandal_heavy_annihilator	
wpn_mandal_mangler_mk1	
wpn_mandal_qv3_disruptor	
wpn_mandal_qv5_disruptor	
wpn_mandal_super_mangler	
wpn_medium_blaster	
wpn_medium_blaster_green	
wpn_medium_disruptor	
wpn_medium_ioncannon	
wpn_mining_laser_mk1	
wpn_mining_laser_mk2	
wpn_mining_laser_mk3	
wpn_mission_reward_imperial_cygnus_starblaster	
wpn_mission_reward_imperial_sds_boltdriver	
wpn_mission_reward_neutral_borstel_disruptor	
wpn_mission_reward_neutral_hk_military_blaster	
wpn_mission_reward_neutral_mandal_light_blaster	
wpn_mission_reward_rebel_incom_tricannon	
wpn_mission_reward_rebel_taim_ion_driver	
wpn_moncal_light_blaster	
wpn_prototype	
wpn_prototype_tie	
wpn_rendili_advanced	
wpn_rendili_fr13_disruptor	
wpn_rendili_fr9_disruptor	
wpn_rendili_sc3_disruptor	
wpn_rendili_sc8_disruptor	
wpn_rss_imperial_cannon	
wpn_sds_elite	
wpn_sds_heavy_imperial_spc_forces_cannon	
wpn_sds_imperial_blaster_1	
wpn_sds_imperial_blaster_2	
wpn_sds_imperial_special_forces_cannon	
wpn_sds_modified_elite	
wpn_seinar_disruptor	
wpn_seinar_ion_cannon	
wpn_seinar_linked_cannon	
wpn_seinar_ls1	
wpn_seinar_ls72	
wpn_sfs_elite	
wpn_sfs_imperial_blaster_1	
wpn_sfs_imperial_blaster_2	
wpn_sfs_imperial_blaster_3	
wpn_sfs_imperial_blaster_4	
wpn_sfs_imperial_special_forces_blaster	
wpn_sfs_improved_imperial_blaster_2	
wpn_slayn_deluxe_light_ioncannon	
wpn_slayn_ioncannon	
wpn_slayn_light_ioncannon	
wpn_subpro_advanced_cannon	
wpn_subpro_improved_light_ioncannon	
wpn_subpro_light_ioncannon	
wpn_subpro_modified_tricannon	
wpn_subpro_tricannon	
wpn_subpro_tripleblaster	
wpn_subpro_tripleblaster_mark2	
wpn_subpro_tripleblaster_mark3	
wpn_taim_elite	
wpn_taim_heavy_laser	
wpn_taim_ix4	
wpn_taim_ix5	
wpn_taim_kx5	
wpn_taim_kx8	
wpn_taim_kx9	
wpn_tieadvanced_blaster	
wpn_tractor_beam_gun	
wpn_tractor_pulse_gun	
wpn_trandoshan_fg1a	
wpn_vengeance_ion_cannon	
wpn_vulcan_cannon	
wpn_z95_blaster	
wpn_heavy_ionic_pulse_weapon	
wpn_crafted_mining_laser_mk1	
wpn_crafted_mining_laser_mk2	
wpn_crafted_mining_laser_mk3	
wpn_crafted_mining_laser_elite	
wpn_ionic_pulse_weapon	
wpn_reward_seinar_elite	
wpn_kessel_imperial_rendili_prototype_x	
wpn_kessel_imperial_sds_experimental_secret_ops	
wpn_kessel_imperial_sfs_elite_ops	
wpn_kessel_rebel_incom_dualcore_flashcannon	
wpn_kessel_rebel_riiz_combine_slammer_cannon	
wpn_kessel_rebel_unknown_rayslinger	
wpn_reward_incom_elite	
wpn_reward_seinar_elite	
wpn_reward_slayn_elite	
wpn_reward_subpro_elite	
wpn_reward_taim_elite	
wpn_nova_ioncannon	
wpn_orion_disruptor	
wpn_borstel_experimental	
