MOODS	greeter_bad_mood	greeter_good_mood	greeter_angry_mood	greeter_neutral_mood
s	s	s	s	s
alert	ambivalent	adventurous	angry	calm
bubbly	annoyed	alert	bitter	casual
casual	callous	amused	cocky	content
cheerful	contemptuous	approving	cold	firm
dignified	crotchety	brave	contemptuous	indifferent
earnest	crude	bubbly	cruel	innocent
ecstatic	cynical	cheerful	evil	neutral
encouraging	defensive	compassionate	fanatical	none
enthusiastic	devious	discreet	malevolent	quiet
exuberant	disappointed	dreamy	mean	sedate
friendly	disdainful	earnest	obnoxious	serious
happy	disgusted	ecstatic	perturbed	thoughtful
joyful	doubtful	encouraging	petulant	
playful	emotionless	enthusiastic	rude	
polite	exasperated	exuberant	scornful
respectful	exhausted	friendly	taunting
sincere	gloomy	happy	vengeful
warm	grumpy	heroic	wicked
	guilty	interested	
	hopeless	joyful	
	indignant	lofty	
	mischievous	loving	
	pessimistic	optimistic	
	pompous	patient	
	resigned	playful	
	sad	polite	
	smug	relieved	
	snobby	respectful	
	spiteful	sincere	
	sullen	tolerant	
	unhappy	warm
	unwilling	youthful
	wary	
	worried	
