sceneName	adjust_map_coordinates
s	b[0]
kashyyyk_dead_forest	
kashyyyk_hunting	
kashyyyk_main	
kashyyyk_north_dungeons	
kashyyyk_pob_dungeons	
kashyyyk_rryatt_trail	1
kashyyyk_south_dungeons	
simple	
tatooine	
corellia	
naboo	
rori	
talus	
dantooine	
dathomir	
endor	
yavin4	
lok	
mustafar	
dungeon1	1
adventure1	1
adventure2	1
taanab	0
dungeon_hub	0
adventure3	0
