ServerTemplate	SharedTemplate	Likelihood
s	s	f
object/static/space/debris/cargo_destroyed_large_a.iff	object/static/space/debris/shared_cargo_destroyed_large_a.iff	5
object/static/space/debris/cargo_destroyed_small_a.iff	object/static/space/debris/shared_cargo_destroyed_small_a.iff	5
object/static/space/debris/cargo_destroyed_large_a.iff	object/static/space/debris/shared_cargo_destroyed_large_a.iff	5
object/static/space/debris/cargo_destroyed_small_a.iff	object/static/space/debris/shared_cargo_destroyed_small_a.iff	5
object/static/space/debris/cargo_destroyed_large_a.iff	object/static/space/debris/shared_cargo_destroyed_large_a.iff	5
object/static/space/debris/cargo_destroyed_small_a.iff	object/static/space/debris/shared_cargo_destroyed_small_a.iff	5
object/static/space/debris/xwing_debris_a.iff	object/static/space/debris/shared_xwing_debris_a.iff	1
object/static/space/debris/xwing_debris_b.iff	object/static/space/debris/shared_xwing_debris_b.iff	2
object/static/space/debris/xwing_debris_c.iff	object/static/space/debris/shared_xwing_debris_c.iff	1
object/static/space/debris/xwing_debris_d.iff	object/static/space/debris/shared_xwing_debris_d.iff	2
object/static/space/debris/xwing_debris_e.iff	object/static/space/debris/shared_xwing_debris_e.iff	1
object/static/space/debris/xwing_debris_f.iff	object/static/space/debris/shared_xwing_debris_f.iff	2
object/static/space/debris/xwing_debris_g.iff	object/static/space/debris/shared_xwing_debris_g.iff	1
object/static/space/debris/tie_fighter_debris_a.iff	object/static/space/debris/shared_tie_fighter_debris_a.iff	2
object/static/space/debris/tie_fighter_debris_b.iff	object/static/space/debris/shared_tie_fighter_debris_b.iff	1
object/static/space/debris/tie_fighter_debris_c.iff	object/static/space/debris/shared_tie_fighter_debris_c.iff	2
object/static/space/debris/tie_fighter_debris_d.iff	object/static/space/debris/shared_tie_fighter_debris_d.iff	1
object/static/space/debris/tie_fighter_debris_e.iff	object/static/space/debris/shared_tie_fighter_debris_e.iff	2
object/static/space/debris/tie_fighter_debris_f.iff	object/static/space/debris/shared_tie_fighter_debris_f.iff	1
