Index	quest1
s	s
Type	destroy
Convo	npc_mission/moisture_farmer
Gating objvar	test
quest_id	moisture_farmer
Reward	object/tangible/loot/misc/broken_blaster.iff
Reward2	
Deliver/Retrieve object	
Deliver/Retrieve object2	
Player script	npc.static_quest.quest_player
NPC	thug
NPC script	npc.static_quest.quest_npc
NPC name	
NPC2	
NPC2 script	
NPC2 name
Extra attack point
Secondary spawn
Extras
