Item	Certifications Required
s	s
object/tangible/droid/navicomputer_1.iff	@cmd_n:cert_droid_astromech_1
object/tangible/droid/navicomputer_2.iff	@cmd_n:cert_droid_astromech_2
object/tangible/droid/navicomputer_3.iff	@cmd_n:cert_droid_astromech_3
object/tangible/droid/navicomputer_4.iff	@cmd_n:cert_droid_astromech_4
object/tangible/droid/navicomputer_5.iff	@cmd_n:cert_droid_astromech_5
object/tangible/droid/navicomputer_6.iff	@cmd_n:cert_droid_astromech_6
object/tangible/ship/components/armor/arm_corellian_advanced_durasteel.iff	@cmd_n:cert_ordnance_level7
object/tangible/ship/components/armor/arm_corellian_cheap_durasteel.iff	@cmd_n:cert_ordnance_level1
object/tangible/ship/components/armor/arm_corellian_elite_durasteel.iff	@cmd_n:cert_ordnance_level9
object/tangible/ship/components/armor/arm_corellian_enhanced_elite_plastisteel.iff	@cmd_n:cert_ordnance_levelten
object/tangible/ship/components/armor/arm_corellian_heavy_durasteel.iff	@cmd_n:cert_ordnance_level6
object/tangible/ship/components/armor/arm_corellian_improved_advanced_durasteel.iff	@cmd_n:cert_ordnance_level8
object/tangible/ship/components/armor/arm_corellian_light_durasteel.iff	@cmd_n:cert_ordnance_level2
object/tangible/ship/components/armor/arm_corellian_modified_heavy_durasteel.iff	@cmd_n:cert_ordnance_level7
object/tangible/ship/components/armor/arm_corellian_reinforced_light_durasteel.iff	@cmd_n:cert_ordnance_level3
object/tangible/ship/components/armor/arm_corellian_reinforced_supreme_durasteel.iff	@cmd_n:cert_ordnance_level9
object/tangible/ship/components/armor/arm_corellian_special_standard_durasteel.iff	@cmd_n:cert_ordnance_level6
object/tangible/ship/components/armor/arm_corellian_standard_durasteel.iff	@cmd_n:cert_ordnance_level4
object/tangible/ship/components/armor/arm_corellian_supreme_durasteel.iff	@cmd_n:cert_ordnance_level8
object/tangible/ship/components/armor/arm_cygnus_light_weave.iff	@cmd_n:cert_ordnance_level2
object/tangible/ship/components/armor/arm_cygnus_standard_weave.iff	@cmd_n:cert_ordnance_level3
object/tangible/ship/components/armor/arm_fibertech_steel_plating.iff	@cmd_n:cert_ordnance_level8
object/tangible/ship/components/armor/arm_freitek_deluxe_light.iff	@cmd_n:cert_ordnance_level2
object/tangible/ship/components/armor/arm_freitek_standard.iff	@cmd_n:cert_ordnance_level4
object/tangible/ship/components/armor/arm_gallofree_mk1.iff	@cmd_n:cert_ordnance_level1
object/tangible/ship/components/armor/arm_gallofree_mk2.iff	@cmd_n:cert_ordnance_level3
object/tangible/ship/components/armor/arm_generic.iff	@cmd_n:cert_ordnance_level3
object/tangible/ship/components/armor/arm_incom_light_plate.iff	@cmd_n:cert_ordnance_level1
object/tangible/ship/components/armor/arm_incom_modified_standard_plate.iff	@cmd_n:cert_ordnance_level4
object/tangible/ship/components/armor/arm_incom_standard_plate.iff	@cmd_n:cert_ordnance_level3
object/tangible/ship/components/armor/arm_kessel_imperial_rendili_crystalline_durasteel.iff	@cmd_n:cert_ordnance_level9
object/tangible/ship/components/armor/arm_kessel_imperial_sds_imperial_impervious.iff	@cmd_n:cert_ordnance_levelten
object/tangible/ship/components/armor/arm_kessel_imperial_sfs_imperial_finest.iff	@cmd_n:cert_ordnance_level9
object/tangible/ship/components/armor/arm_kessel_rebel_mandal_corrugated_plastisteel.iff	@cmd_n:cert_ordnance_level9
object/tangible/ship/components/armor/arm_kessel_rebel_slayn_flexsteel_multilayer.iff	@cmd_n:cert_ordnance_levelten
object/tangible/ship/components/armor/arm_kessel_rebel_sorosuub_spidershell_plating.iff	@cmd_n:cert_ordnance_level9
object/tangible/ship/components/armor/arm_koensayr_advanced_durasteel.iff	@cmd_n:cert_ordnance_level6
object/tangible/ship/components/armor/arm_koensayr_b5_durasteel.iff	@cmd_n:cert_ordnance_level1
object/tangible/ship/components/armor/arm_koensayr_b9_durasteel.iff	@cmd_n:cert_ordnance_level1
object/tangible/ship/components/armor/arm_koensayr_elite_plastisteel.iff	@cmd_n:cert_ordnance_level9
object/tangible/ship/components/armor/arm_koensayr_enhanced_heavy_durasteel.iff	@cmd_n:cert_ordnance_level5
object/tangible/ship/components/armor/arm_koensayr_enhanced_standard_durasteel.iff	@cmd_n:cert_ordnance_level4
object/tangible/ship/components/armor/arm_koensayr_heavy_durasteel.iff	@cmd_n:cert_ordnance_level4
object/tangible/ship/components/armor/arm_koensayr_improved_elite_plastisteel.iff	@cmd_n:cert_ordnance_level9
object/tangible/ship/components/armor/arm_koensayr_light_advanced_durasteel.iff	@cmd_n:cert_ordnance_level5
object/tangible/ship/components/armor/arm_koensayr_limited_heavy_durasteel.iff	@cmd_n:cert_ordnance_level6
object/tangible/ship/components/armor/arm_koensayr_limited_supreme_durasteel.iff	@cmd_n:cert_ordnance_level8
object/tangible/ship/components/armor/arm_koensayr_promotional_b9_durasteel.iff	@cmd_n:cert_ordnance_level3
object/tangible/ship/components/armor/arm_koensayr_reinforced_b5_durasteel.iff	@cmd_n:cert_ordnance_level2
object/tangible/ship/components/armor/arm_koensayr_special_supreme_durasteel.iff	@cmd_n:cert_ordnance_level8
object/tangible/ship/components/armor/arm_koensayr_standard_durasteel.iff	@cmd_n:cert_ordnance_level3
object/tangible/ship/components/armor/arm_koensayr_supreme_durasteel.iff	@cmd_n:cert_ordnance_level7
object/tangible/ship/components/armor/arm_koensayr_thick_advanced_durasteel.iff	@cmd_n:cert_ordnance_level7
object/tangible/ship/components/armor/arm_kse_advanced_durasteel.iff	@cmd_n:cert_ordnance_level6
object/tangible/ship/components/armor/arm_kse_customized_advanced_durasteel.iff	@cmd_n:cert_ordnance_level7
object/tangible/ship/components/armor/arm_kse_elite_durasteel.iff	@cmd_n:cert_ordnance_level8
object/tangible/ship/components/armor/arm_kse_heavy_durasteel.iff	@cmd_n:cert_ordnance_level4
object/tangible/ship/components/armor/arm_kse_intermediate_durasteel.iff	@cmd_n:cert_ordnance_level2
object/tangible/ship/components/armor/arm_kse_limited_heavy_durasteel.iff	@cmd_n:cert_ordnance_level6
object/tangible/ship/components/armor/arm_kse_modified_heavy_durasteel.iff	@cmd_n:cert_ordnance_level5
object/tangible/ship/components/armor/arm_kse_modified_light_durasteel.iff	@cmd_n:cert_ordnance_level2
object/tangible/ship/components/armor/arm_kse_modified_supreme_durasteel.iff	@cmd_n:cert_ordnance_level8
object/tangible/ship/components/armor/arm_kse_standard_durasteel.iff	@cmd_n:cert_ordnance_level3
object/tangible/ship/components/armor/arm_kse_supreme_durasteel.iff	@cmd_n:cert_ordnance_level7
object/tangible/ship/components/armor/arm_mandal_advanced_composite.iff	@cmd_n:cert_ordnance_level7
object/tangible/ship/components/armor/arm_mandal_composite_j5.iff	@cmd_n:cert_ordnance_level1
object/tangible/ship/components/armor/arm_mandal_composite_j7.iff	@cmd_n:cert_ordnance_level3
object/tangible/ship/components/armor/arm_mandal_custom_heavy_composite.iff	@cmd_n:cert_ordnance_level5
object/tangible/ship/components/armor/arm_mandal_double_insulated_i5.iff	@cmd_n:cert_ordnance_level6
object/tangible/ship/components/armor/arm_mandal_double_insulated_i7.iff	@cmd_n:cert_ordnance_level8
object/tangible/ship/components/armor/arm_mandal_double_plated_composite_j7.iff	@cmd_n:cert_ordnance_level4
object/tangible/ship/components/armor/arm_mandal_elite_composite.iff	@cmd_n:cert_ordnance_levelten
object/tangible/ship/components/armor/arm_mandal_enhanced_elite_composite.iff	@cmd_n:cert_ordnance_levelten
object/tangible/ship/components/armor/arm_mandal_enhanced_heavy_composite.iff	@cmd_n:cert_ordnance_level6
object/tangible/ship/components/armor/arm_mandal_heavy_composite.iff	@cmd_n:cert_ordnance_level5
object/tangible/ship/components/armor/arm_mandal_insulated_i7.iff	@cmd_n:cert_ordnance_level7
object/tangible/ship/components/armor/arm_mandal_modified_supreme_composite.iff	@cmd_n:cert_ordnance_level9
object/tangible/ship/components/armor/arm_mandal_modifier_composite_j5.iff	@cmd_n:cert_ordnance_level2
object/tangible/ship/components/armor/arm_mandal_reinforced_advanced_composite.iff	@cmd_n:cert_ordnance_level8
object/tangible/ship/components/armor/arm_mandal_supreme_composite.iff	@cmd_n:cert_ordnance_level9
object/tangible/ship/components/armor/arm_mission_reward_imperial_rss_special_durasteel.iff	@cmd_n:cert_ordnance_level8
object/tangible/ship/components/armor/arm_mission_reward_imperial_sfs_light_military.iff	@cmd_n:cert_ordnance_level4
object/tangible/ship/components/armor/arm_mission_reward_neutral_kse_handcrafted.iff	@cmd_n:cert_ordnance_level6
object/tangible/ship/components/armor/arm_mission_reward_rebel_corellian_triplate.iff	@cmd_n:cert_ordnance_level6
object/tangible/ship/components/armor/arm_mission_reward_rebel_incom_ultralight.iff	@cmd_n:cert_ordnance_level1
object/tangible/ship/components/armor/arm_moncal_advanced_weave.iff	@cmd_n:cert_ordnance_levelten
object/tangible/ship/components/armor/arm_moncal_elite_weave.iff	@cmd_n:cert_ordnance_levelten
object/tangible/ship/components/armor/arm_moncal_improved_light_weave.iff	@cmd_n:cert_ordnance_level2
object/tangible/ship/components/armor/arm_moncal_light_weave.iff	@cmd_n:cert_ordnance_level1
object/tangible/ship/components/armor/arm_moncal_supreme_weave.iff	@cmd_n:cert_ordnance_levelten
object/tangible/ship/components/armor/arm_prototype_armor.iff	@cmd_n:cert_ordnance_level1
object/tangible/ship/components/armor/arm_rendili_tough_plate.iff	@cmd_n:cert_ordnance_level2
object/tangible/ship/components/armor/arm_reward_alderaan_elite.iff	@cmd_n:cert_ordnance_levelten
object/tangible/ship/components/armor/arm_reward_baktoid_elite.iff	@cmd_n:cert_ordnance_levelten
object/tangible/ship/components/armor/arm_reward_freitek_elite.iff	@cmd_n:cert_ordnance_levelten
object/tangible/ship/components/armor/arm_reward_mandal_elite.iff	@cmd_n:cert_ordnance_levelten
object/tangible/ship/components/armor/arm_reward_subpro_elite.iff	@cmd_n:cert_ordnance_levelten
object/tangible/ship/components/armor/arm_rss_light_plastisteel.iff	@cmd_n:cert_ordnance_level1
object/tangible/ship/components/armor/arm_sds_triplate_system.iff	@cmd_n:cert_ordnance_level4
object/tangible/ship/components/armor/arm_sfs_enhanced_standard_durasteel.iff	@cmd_n:cert_ordnance_level4
object/tangible/ship/components/armor/arm_sfs_light_durasteel.iff	@cmd_n:cert_ordnance_level1
object/tangible/ship/components/armor/arm_sfs_standard_durasteel.iff	@cmd_n:cert_ordnance_level3
object/tangible/ship/components/armor/arm_slayn_tech_weave.iff	@cmd_n:cert_ordnance_level2
object/tangible/ship/components/armor/arm_sorosuub_advanced_plastisteel.iff	@cmd_n:cert_ordnance_level9
object/tangible/ship/components/armor/arm_sorosuub_elite_plastisteel.iff	@cmd_n:cert_ordnance_levelten
object/tangible/ship/components/armor/arm_sorosuub_enhanced_advanced_plastisteel.iff	@cmd_n:cert_ordnance_level9
object/tangible/ship/components/armor/arm_sorosuub_heavy_plastisteel.iff	@cmd_n:cert_ordnance_level5
object/tangible/ship/components/armor/arm_sorosuub_improved_light_plastisteel.iff	@cmd_n:cert_ordnance_level2
object/tangible/ship/components/armor/arm_sorosuub_intemediate_plastisteel.iff	@cmd_n:cert_ordnance_level3
object/tangible/ship/components/armor/arm_sorosuub_modified_elite_plastisteel.iff	@cmd_n:cert_ordnance_levelten
object/tangible/ship/components/armor/arm_sorosuub_special_intermediate_durasteel.iff	@cmd_n:cert_ordnance_level4
object/tangible/ship/components/armor/arm_subpro_advanced_plasisteel.iff	@cmd_n:cert_ordnance_level8
object/tangible/ship/components/armor/arm_subpro_bargain_plastisteel.iff	@cmd_n:cert_ordnance_level1
object/tangible/ship/components/armor/arm_subpro_elite_plastisteel.iff	@cmd_n:cert_ordnance_levelten
object/tangible/ship/components/armor/arm_subpro_enhanced_supreme_plastisteel.iff	@cmd_n:cert_ordnance_level9
object/tangible/ship/components/armor/arm_subpro_experimental_advanced_plastisteel.iff	@cmd_n:cert_ordnance_level8
object/tangible/ship/components/armor/arm_subpro_heavy_plastisteel.iff	@cmd_n:cert_ordnance_level7
object/tangible/ship/components/armor/arm_subpro_improved_light_plastisteel.iff	@cmd_n:cert_ordnance_level3
object/tangible/ship/components/armor/arm_subpro_improved_standard_durasteel.iff	@cmd_n:cert_ordnance_level5
object/tangible/ship/components/armor/arm_subpro_limited_heavy_plastisteel.iff	@cmd_n:cert_ordnance_level7
object/tangible/ship/components/armor/arm_subpro_special_elite_plastisteel.iff	@cmd_n:cert_ordnance_levelten
object/tangible/ship/components/armor/arm_subpro_standard_plastisteel.iff	@cmd_n:cert_ordnance_level4
object/tangible/ship/components/armor/arm_subpro_supreme_plastisteel.iff	@cmd_n:cert_ordnance_level9
object/tangible/ship/components/armor/arm_ur_0015_rancor.iff	@cmd_n:cert_ordnance_level6
object/tangible/ship/components/armor/armor_alderaan_royal_plate.iff	@cmd_n:cert_ordnance_level4
object/tangible/ship/components/armor/armor_alderaan_royal_weave.iff	@cmd_n:cert_ordnance_level4
object/tangible/ship/components/armor/armor_baktoid_mtt_prototype.iff	@cmd_n:cert_ordnance_level2
object/tangible/ship/components/armor/armor_baktoid_shock_armor.iff	@cmd_n:cert_ordnance_level2
object/tangible/ship/components/armor/armor_baktoid_spider_shell_g2.iff	@cmd_n:cert_ordnance_level2
object/tangible/ship/components/armor/armor_freitek_es4_durasteel.iff	@cmd_n:cert_ordnance_level3
object/tangible/ship/components/armor/armor_freitek_ew6_prototype.iff	@cmd_n:cert_ordnance_level3
object/tangible/ship/components/armor/armor_mandal_composite_j14.iff	@cmd_n:cert_ordnance_level3
object/tangible/ship/components/armor/armor_mandal_insulated_i5.iff	@cmd_n:cert_ordnance_level4
object/tangible/ship/components/armor/armor_seinar_coated_plasteel.iff	@cmd_n:cert_ordnance_level1
object/tangible/ship/components/armor/armor_seinar_enhanced_plasteel.iff	@cmd_n:cert_ordnance_level1
object/tangible/ship/components/armor/armor_subpro_corrugated_durasteel.iff	@cmd_n:cert_ordnance_level6
object/tangible/ship/components/armor/armor_subpro_light_plasteel.iff	@cmd_n:cert_ordnance_level5
object/tangible/ship/components/armor/armor_subpro_reinforced_plasteel.iff	@cmd_n:cert_ordnance_level6
object/tangible/ship/components/armor/armor_test.iff	@cmd_n:cert_ordnance_level1
object/tangible/ship/components/armor/armor_tiefighter_basic.iff	@cmd_n:cert_ordnance_level1
object/tangible/ship/components/armor/armor_trilon_custom.iff	@cmd_n:cert_ordnance_level5
object/tangible/ship/components/armor/armor_trilon_unknown.iff	@cmd_n:cert_ordnance_level5
object/tangible/ship/components/armor/armor_z95_basic.iff	@cmd_n:cert_ordnance_level1
object/tangible/ship/components/booster/booster_test.iff	@cmd_n:cert_ordnance_level1
object/tangible/ship/components/booster/bst_corellian_advanced_thrust_enhancer.iff	@cmd_n:cert_ordnance_level7
object/tangible/ship/components/booster/bst_corellian_elite_thrust_enhancer.iff	@cmd_n:cert_ordnance_level9
object/tangible/ship/components/booster/bst_corellian_experimental_tjh3.iff	@cmd_n:cert_ordnance_level2
object/tangible/ship/components/booster/bst_corellian_heavy_thrust_enhancer.iff	@cmd_n:cert_ordnance_level5
object/tangible/ship/components/booster/bst_corellian_highly_modified_elite_thrust_enhancer.iff	@cmd_n:cert_ordnance_levelten
object/tangible/ship/components/booster/bst_corellian_performance_advanced_thrust_enhancer.iff	@cmd_n:cert_ordnance_level8
object/tangible/ship/components/booster/bst_corellian_promotional_standard_thrust_enhancer.iff	@cmd_n:cert_ordnance_level4
object/tangible/ship/components/booster/bst_corellian_standard_thrust_enhancer.iff	@cmd_n:cert_ordnance_level3
object/tangible/ship/components/booster/bst_corellian_tjh3.iff	@cmd_n:cert_ordnance_level1
object/tangible/ship/components/booster/bst_corellian_tuned_heavy_thrust_enhancer.iff	@cmd_n:cert_ordnance_level6
object/tangible/ship/components/booster/bst_cygnus_flashboost3.iff	@cmd_n:cert_ordnance_level2
object/tangible/ship/components/booster/bst_cygnus_flashboost4.iff	@cmd_n:cert_ordnance_level3
object/tangible/ship/components/booster/bst_freitek_outrunner_x1.iff	@cmd_n:cert_ordnance_level2
object/tangible/ship/components/booster/bst_gallofree_light.iff	@cmd_n:cert_ordnance_level1
object/tangible/ship/components/booster/bst_generic.iff	@cmd_n:cert_ordnance_level1
object/tangible/ship/components/booster/bst_incom_deluxe_fynock.iff	@cmd_n:cert_ordnance_level8
object/tangible/ship/components/booster/bst_incom_elite_sls_1.iff	@cmd_n:cert_ordnance_levelten
object/tangible/ship/components/booster/bst_incom_enhanced_mynock.iff	@cmd_n:cert_ordnance_level4
object/tangible/ship/components/booster/bst_incom_fynock.iff	@cmd_n:cert_ordnance_level7
object/tangible/ship/components/booster/bst_incom_intimidator_mk1.iff	@cmd_n:cert_ordnance_level1
object/tangible/ship/components/booster/bst_incom_intimidator_mk2.iff	@cmd_n:cert_ordnance_level3
object/tangible/ship/components/booster/bst_incom_intimidator_mk3.iff	@cmd_n:cert_ordnance_level5
object/tangible/ship/components/booster/bst_incom_intimidator_mk4.iff	@cmd_n:cert_ordnance_level7
object/tangible/ship/components/booster/bst_incom_mynock.iff	@cmd_n:cert_ordnance_level3
object/tangible/ship/components/booster/bst_incom_nkj31.iff	@cmd_n:cert_ordnance_level1
object/tangible/ship/components/booster/bst_incom_performance_nkj31.iff	@cmd_n:cert_ordnance_level2
object/tangible/ship/components/booster/bst_incom_sls_1.iff	@cmd_n:cert_ordnance_level9
object/tangible/ship/components/booster/bst_incom_supercharged_vynock.iff	@cmd_n:cert_ordnance_level6
object/tangible/ship/components/booster/bst_incom_vynock.iff	@cmd_n:cert_ordnance_level5
object/tangible/ship/components/booster/bst_kde_br12.iff	@cmd_n:cert_ordnance_level4
object/tangible/ship/components/booster/bst_kessel_imperial_cygnus_hyperthrust.iff	@cmd_n:cert_ordnance_level9
object/tangible/ship/components/booster/bst_kessel_imperial_sds_experimental_b7.iff	@cmd_n:cert_ordnance_levelten
object/tangible/ship/components/booster/bst_kessel_imperial_sfs_ultra_thrust.iff	@cmd_n:cert_ordnance_level9
object/tangible/ship/components/booster/bst_kessel_rebel_incom_quicksilver.iff	@cmd_n:cert_ordnance_level9
object/tangible/ship/components/booster/bst_kessel_rebel_incom_windrunner.iff	@cmd_n:cert_ordnance_levelten
object/tangible/ship/components/booster/bst_kessel_rebel_mandal_lightning_m1.iff	@cmd_n:cert_ordnance_level9
object/tangible/ship/components/booster/bst_koensayr_advanced.iff	@cmd_n:cert_ordnance_level7
object/tangible/ship/components/booster/bst_koensayr_charged_advanced.iff	@cmd_n:cert_ordnance_level8
object/tangible/ship/components/booster/bst_koensayr_deluxe_elite.iff	@cmd_n:cert_ordnance_levelten
object/tangible/ship/components/booster/bst_koensayr_elite.iff	@cmd_n:cert_ordnance_level9
object/tangible/ship/components/booster/bst_koensayr_evh12.iff	@cmd_n:cert_ordnance_level1
object/tangible/ship/components/booster/bst_koensayr_heavy.iff	@cmd_n:cert_ordnance_level5
object/tangible/ship/components/booster/bst_koensayr_improved_standard.iff	@cmd_n:cert_ordnance_level4
object/tangible/ship/components/booster/bst_koensayr_modified_heavy.iff	@cmd_n:cert_ordnance_level6
object/tangible/ship/components/booster/bst_koensayr_racer_mk1.iff	@cmd_n:cert_ordnance_level5
object/tangible/ship/components/booster/bst_koensayr_racer_mk2.iff	@cmd_n:cert_ordnance_level7
object/tangible/ship/components/booster/bst_koensayr_racer_mk3.iff	@cmd_n:cert_ordnance_level9
object/tangible/ship/components/booster/bst_koensayr_racer_mk4.iff	@cmd_n:cert_ordnance_levelten
object/tangible/ship/components/booster/bst_koensayr_special_evh12.iff	@cmd_n:cert_ordnance_level2
object/tangible/ship/components/booster/bst_koensayr_standard.iff	@cmd_n:cert_ordnance_level3
object/tangible/ship/components/booster/bst_kse_als_1.iff	@cmd_n:cert_ordnance_level9
object/tangible/ship/components/booster/bst_kse_bti1.iff	@cmd_n:cert_ordnance_level3
object/tangible/ship/components/booster/bst_kse_bti2.iff	@cmd_n:cert_ordnance_level5
object/tangible/ship/components/booster/bst_kse_bti3.iff	@cmd_n:cert_ordnance_level7
object/tangible/ship/components/booster/bst_kse_cb6.iff	@cmd_n:cert_ordnance_level1
object/tangible/ship/components/booster/bst_kse_deluxe_bti3.iff	@cmd_n:cert_ordnance_level8
object/tangible/ship/components/booster/bst_kse_elite_als_1.iff	@cmd_n:cert_ordnance_levelten
object/tangible/ship/components/booster/bst_kse_enhanced_bti2.iff	@cmd_n:cert_ordnance_level6
object/tangible/ship/components/booster/bst_kse_performance_bti1.iff	@cmd_n:cert_ordnance_level4
object/tangible/ship/components/booster/bst_kse_performance_cb6.iff	@cmd_n:cert_ordnance_level2
object/tangible/ship/components/booster/bst_kuat_military_mk1.iff	@cmd_n:cert_ordnance_level1
object/tangible/ship/components/booster/bst_kuat_military_mk2.iff	@cmd_n:cert_ordnance_level4
object/tangible/ship/components/booster/bst_kuat_military_mk3.iff	@cmd_n:cert_ordnance_level8
object/tangible/ship/components/booster/bst_kuat_military_mk4.iff	@cmd_n:cert_ordnance_levelten
object/tangible/ship/components/booster/bst_mandal_deluxe_jbj_mk4.iff	@cmd_n:cert_ordnance_level8
object/tangible/ship/components/booster/bst_mandal_enhanced_jbj_mk1.iff	@cmd_n:cert_ordnance_level2
object/tangible/ship/components/booster/bst_mandal_improved_jbj_mk3.iff	@cmd_n:cert_ordnance_level6
object/tangible/ship/components/booster/bst_mandal_jbj_mk1.iff	@cmd_n:cert_ordnance_level1
object/tangible/ship/components/booster/bst_mandal_jbj_mk2.iff	@cmd_n:cert_ordnance_level3
object/tangible/ship/components/booster/bst_mandal_jbj_mk3.iff	@cmd_n:cert_ordnance_level5
object/tangible/ship/components/booster/bst_mandal_jbj_mk4.iff	@cmd_n:cert_ordnance_level7
object/tangible/ship/components/booster/bst_mandal_jbj_mk5.iff	@cmd_n:cert_ordnance_level9
object/tangible/ship/components/booster/bst_mandal_limited_jbj_mk5.iff	@cmd_n:cert_ordnance_levelten
object/tangible/ship/components/booster/bst_mandal_modified_jbj_mk2.iff	@cmd_n:cert_ordnance_level4
object/tangible/ship/components/booster/bst_mission_reward_imperial_rss_ion_booster.iff	@cmd_n:cert_ordnance_level4
object/tangible/ship/components/booster/bst_mission_reward_neutral_mandal_m_series.iff	@cmd_n:cert_ordnance_level4
object/tangible/ship/components/booster/bst_mission_reward_neutral_mandal_q_series.iff	@cmd_n:cert_ordnance_level8
object/tangible/ship/components/booster/bst_mission_reward_rebel_novaldex_hypernova.iff	@cmd_n:cert_ordnance_level4
object/tangible/ship/components/booster/bst_mission_reward_rebel_qualdex_halcyon.iff	@cmd_n:cert_ordnance_level8
object/tangible/ship/components/booster/bst_moncal_advanced.iff	@cmd_n:cert_ordnance_level7
object/tangible/ship/components/booster/bst_moncal_charged_heavy.iff	@cmd_n:cert_ordnance_level6
object/tangible/ship/components/booster/bst_moncal_deluxe_standard.iff	@cmd_n:cert_ordnance_level4
object/tangible/ship/components/booster/bst_moncal_elite.iff	@cmd_n:cert_ordnance_level9
object/tangible/ship/components/booster/bst_moncal_enhanced_elite.iff	@cmd_n:cert_ordnance_levelten
object/tangible/ship/components/booster/bst_moncal_heavy.iff	@cmd_n:cert_ordnance_level5
object/tangible/ship/components/booster/bst_moncal_jlc37.iff	@cmd_n:cert_ordnance_level1
object/tangible/ship/components/booster/bst_moncal_limited_jlc37.iff	@cmd_n:cert_ordnance_level2
object/tangible/ship/components/booster/bst_moncal_rare_advanced.iff	@cmd_n:cert_ordnance_level8
object/tangible/ship/components/booster/bst_moncal_standard.iff	@cmd_n:cert_ordnance_level3
object/tangible/ship/components/booster/bst_nova_breaker.iff	@cmd_n:cert_ordnance_level6
object/tangible/ship/components/booster/bst_novaldex_pulsar.iff	@cmd_n:cert_ordnance_level5
object/tangible/ship/components/booster/bst_novaldex_pulsar_advanced.iff	@cmd_n:cert_ordnance_level9
object/tangible/ship/components/booster/bst_novaldex_quasar.iff	@cmd_n:cert_ordnance_level7
object/tangible/ship/components/booster/bst_novaldex_quasar_advanced.iff	@cmd_n:cert_ordnance_levelten
object/tangible/ship/components/booster/bst_qualdex_xboost_mk1.iff	@cmd_n:cert_ordnance_level2
object/tangible/ship/components/booster/bst_qualdex_xboost_mk2.iff	@cmd_n:cert_ordnance_level4
object/tangible/ship/components/booster/bst_qualdex_xboost_mk3.iff	@cmd_n:cert_ordnance_level5
object/tangible/ship/components/booster/bst_qualdex_xboost_mk4.iff	@cmd_n:cert_ordnance_level7
object/tangible/ship/components/booster/bst_reward_incom_elite.iff	@cmd_n:cert_ordnance_levelten
object/tangible/ship/components/booster/bst_reward_koensayr_elite.iff	@cmd_n:cert_ordnance_levelten
object/tangible/ship/components/booster/bst_reward_kuat_elite.iff	@cmd_n:cert_ordnance_levelten
object/tangible/ship/components/booster/bst_reward_novaldex_elite.iff	@cmd_n:cert_ordnance_levelten
object/tangible/ship/components/booster/bst_reward_qualdex_elite.iff	@cmd_n:cert_ordnance_levelten
object/tangible/ship/components/booster/bst_rss_special.iff	@cmd_n:cert_ordnance_level4
object/tangible/ship/components/booster/bst_sap_imperial_1.iff	@cmd_n:cert_ordnance_level2
object/tangible/ship/components/booster/bst_sap_imperial_2.iff	@cmd_n:cert_ordnance_level3
object/tangible/ship/components/booster/bst_sds_enhanced_imperial_2.iff	@cmd_n:cert_ordnance_level4
object/tangible/ship/components/booster/bst_sfs_imperial_1.iff	@cmd_n:cert_ordnance_level1
object/tangible/ship/components/booster/bst_sfs_imperial_2.iff	@cmd_n:cert_ordnance_level3
object/tangible/ship/components/booster/bst_slayn_ion_booster_mk1.iff	@cmd_n:cert_ordnance_level1
object/tangible/ship/components/booster/bst_sorosuub_enhanced_liberator_mk4.iff	@cmd_n:cert_ordnance_level8
object/tangible/ship/components/booster/bst_sorosuub_improved_liberator_mk2.iff	@cmd_n:cert_ordnance_level4
object/tangible/ship/components/booster/bst_sorosuub_liberator_mk1.iff	@cmd_n:cert_ordnance_level1
object/tangible/ship/components/booster/bst_sorosuub_liberator_mk2.iff	@cmd_n:cert_ordnance_level3
object/tangible/ship/components/booster/bst_sorosuub_liberator_mk3.iff	@cmd_n:cert_ordnance_level5
object/tangible/ship/components/booster/bst_sorosuub_liberator_mk4.iff	@cmd_n:cert_ordnance_level7
object/tangible/ship/components/booster/bst_sorosuub_liberator_mk5.iff	@cmd_n:cert_ordnance_level9
object/tangible/ship/components/booster/bst_sorosuub_prized_liberator_mk1.iff	@cmd_n:cert_ordnance_level2
object/tangible/ship/components/booster/bst_sorosuub_supercharged_liberator_mk3.iff	@cmd_n:cert_ordnance_level6
object/tangible/ship/components/booster/bst_sorosuub_well_tuned_liberator_mk5.iff	@cmd_n:cert_ordnance_levelten
object/tangible/ship/components/booster/bst_subpro_accelatron_mk1.iff	@cmd_n:cert_ordnance_level1
object/tangible/ship/components/booster/bst_subpro_accelatron_mk2.iff	@cmd_n:cert_ordnance_level3
object/tangible/ship/components/booster/bst_subpro_accelatron_mk3.iff	@cmd_n:cert_ordnance_level5
object/tangible/ship/components/booster/bst_subpro_accelatron_mk4.iff	@cmd_n:cert_ordnance_level7
object/tangible/ship/components/booster/bst_subpro_accelatron_mk5.iff	@cmd_n:cert_ordnance_level9
object/tangible/ship/components/booster/bst_subpro_deluxe_accelatron_mk3.iff	@cmd_n:cert_ordnance_level6
object/tangible/ship/components/booster/bst_subpro_elite_accelatron_mk5.iff	@cmd_n:cert_ordnance_levelten
object/tangible/ship/components/booster/bst_subpro_enhanced_accelatron_mk2.iff	@cmd_n:cert_ordnance_level4
object/tangible/ship/components/booster/bst_subpro_modified_accelatron_mk4.iff	@cmd_n:cert_ordnance_level8
object/tangible/ship/components/booster/bst_subpro_tuned_accelatron_mk1.iff	@cmd_n:cert_ordnance_level2
object/tangible/ship/components/booster/bst_surronian_accelerator_mk1.iff	@cmd_n:cert_ordnance_level6
object/tangible/ship/components/booster/bst_surronian_accelerator_mk2.iff	@cmd_n:cert_ordnance_level8
object/tangible/ship/components/booster/bst_surronian_nomad_x4.iff	@cmd_n:cert_ordnance_level2
object/tangible/ship/components/booster/bst_surronian_nomad_x8.iff	@cmd_n:cert_ordnance_level4
object/tangible/ship/components/booster/bst_tiefighter_basic.iff	@cmd_n:cert_ordnance_level1
object/tangible/ship/components/booster/bst_z95_basic.iff	@cmd_n:cert_ordnance_level1
object/tangible/ship/components/booster/xwing_booster_test.iff	@cmd_n:cert_ordnance_level1
object/tangible/ship/components/cargo_hold/crg_mining_large.iff	@cmd_n:cert_ordnance_level1
object/tangible/ship/components/cargo_hold/crg_mining_small.iff	@cmd_n:cert_ordnance_level1
object/tangible/ship/components/cargo_hold/crg_pob_large.iff	@cmd_n:cert_ordnance_level1
object/tangible/ship/components/cargo_hold/crg_pob_small.iff	@cmd_n:cert_ordnance_level1
object/tangible/ship/components/cargo_hold/crg_starfighter_large.iff	@cmd_n:cert_ordnance_level1
object/tangible/ship/components/cargo_hold/crg_starfighter_small.iff	@cmd_n:cert_ordnance_level1
object/tangible/ship/components/droid_interface/ddi_armek_military_grade_mk1.iff	@cmd_n:cert_ordnance_level7
object/tangible/ship/components/droid_interface/ddi_armek_military_grade_mk2.iff	@cmd_n:cert_ordnance_levelten
object/tangible/ship/components/droid_interface/ddi_cygnus_di6.iff	@cmd_n:cert_ordnance_level2
object/tangible/ship/components/droid_interface/ddi_cygnus_di8.iff	@cmd_n:cert_ordnance_level6
object/tangible/ship/components/droid_interface/ddi_freitek_droid_commander_mk1.iff	@cmd_n:cert_ordnance_level3
object/tangible/ship/components/droid_interface/ddi_freitek_droid_commander_mk2.iff	@cmd_n:cert_ordnance_level6
object/tangible/ship/components/droid_interface/ddi_freitek_droid_commander_mk3.iff	@cmd_n:cert_ordnance_level8
object/tangible/ship/components/droid_interface/ddi_freitek_elite.iff	@cmd_n:cert_ordnance_levelten
object/tangible/ship/components/droid_interface/ddi_freitek_modified_droid_commander_mk1.iff	@cmd_n:cert_ordnance_level4
object/tangible/ship/components/droid_interface/ddi_gallofree_level1.iff	@cmd_n:cert_ordnance_level5
object/tangible/ship/components/droid_interface/ddi_generic.iff	@cmd_n:cert_ordnance_level1
object/tangible/ship/components/droid_interface/ddi_haor_chall_old_tech.iff	@cmd_n:cert_ordnance_level3
object/tangible/ship/components/droid_interface/ddi_haor_chall_vintage_piece.iff	@cmd_n:cert_ordnance_level4
object/tangible/ship/components/droid_interface/ddi_hk_advanced.iff	@cmd_n:cert_ordnance_level9
object/tangible/ship/components/droid_interface/ddi_hk_elite.iff	@cmd_n:cert_ordnance_levelten
object/tangible/ship/components/droid_interface/ddi_hk_mk1.iff	@cmd_n:cert_ordnance_level5
object/tangible/ship/components/droid_interface/ddi_hk_mk2.iff	@cmd_n:cert_ordnance_level6
object/tangible/ship/components/droid_interface/ddi_hk_mk3.iff	@cmd_n:cert_ordnance_level7
object/tangible/ship/components/droid_interface/ddi_hk_mk4.iff	@cmd_n:cert_ordnance_level8
object/tangible/ship/components/droid_interface/ddi_incom_advanced_droid_interface.iff	@cmd_n:cert_ordnance_level9
object/tangible/ship/components/droid_interface/ddi_incom_deluxe_droid_interface_mk1.iff	@cmd_n:cert_ordnance_level2
object/tangible/ship/components/droid_interface/ddi_incom_droid_interface_mk1.iff	@cmd_n:cert_ordnance_level1
object/tangible/ship/components/droid_interface/ddi_incom_droid_interface_mk2.iff	@cmd_n:cert_ordnance_level2
object/tangible/ship/components/droid_interface/ddi_incom_droid_interface_mk3.iff	@cmd_n:cert_ordnance_level4
object/tangible/ship/components/droid_interface/ddi_incom_droid_interface_mk4.iff	@cmd_n:cert_ordnance_level6
object/tangible/ship/components/droid_interface/ddi_incom_elite.iff	@cmd_n:cert_ordnance_levelten
object/tangible/ship/components/droid_interface/ddi_incom_enhanced_droid_interface_mk4.iff	@cmd_n:cert_ordnance_level8
object/tangible/ship/components/droid_interface/ddi_incom_fast_droid_interface_mk2.iff	@cmd_n:cert_ordnance_level4
object/tangible/ship/components/droid_interface/ddi_kde_governor_mk1.iff	@cmd_n:cert_ordnance_level2
object/tangible/ship/components/droid_interface/ddi_kde_governor_mk2.iff	@cmd_n:cert_ordnance_level5
object/tangible/ship/components/droid_interface/ddi_kessel_imperial_cygnus_dp44.iff	@cmd_n:cert_ordnance_level9
object/tangible/ship/components/droid_interface/ddi_kessel_imperial_sds_unknown_prototype.iff	@cmd_n:cert_ordnance_levelten
object/tangible/ship/components/droid_interface/ddi_kessel_imperial_sfs_imperial_finest.iff	@cmd_n:cert_ordnance_level9
object/tangible/ship/components/droid_interface/ddi_kessel_rebel_incom_dx61.iff	@cmd_n:cert_ordnance_level9
object/tangible/ship/components/droid_interface/ddi_kessel_rebel_incom_supreme_interface.iff	@cmd_n:cert_ordnance_levelten
object/tangible/ship/components/droid_interface/ddi_kessel_rebel_qualdex_integrated_array.iff	@cmd_n:cert_ordnance_level9
object/tangible/ship/components/droid_interface/ddi_koensayr_simple_droid_interface.iff	@cmd_n:cert_ordnance_level1
object/tangible/ship/components/droid_interface/ddi_koensayr_standard_droid_interface.iff	@cmd_n:cert_ordnance_level2
object/tangible/ship/components/droid_interface/ddi_kse_advanced_manager.iff	@cmd_n:cert_ordnance_level8
object/tangible/ship/components/droid_interface/ddi_kse_custom_manager_mk2.iff	@cmd_n:cert_ordnance_level4
object/tangible/ship/components/droid_interface/ddi_kse_elite_manager_1.iff	@cmd_n:cert_ordnance_level9
object/tangible/ship/components/droid_interface/ddi_kse_elite_manager_2.iff	@cmd_n:cert_ordnance_levelten
object/tangible/ship/components/droid_interface/ddi_kse_enhanced_manager_mk3.iff	@cmd_n:cert_ordnance_level7
object/tangible/ship/components/droid_interface/ddi_kse_improved_manager_mk1.iff	@cmd_n:cert_ordnance_level2
object/tangible/ship/components/droid_interface/ddi_kse_manager_mk1.iff	@cmd_n:cert_ordnance_level1
object/tangible/ship/components/droid_interface/ddi_kse_manager_mk2.iff	@cmd_n:cert_ordnance_level3
object/tangible/ship/components/droid_interface/ddi_kse_manager_mk3.iff	@cmd_n:cert_ordnance_level6
object/tangible/ship/components/droid_interface/ddi_mandal_military_grade_mk1.iff	@cmd_n:cert_ordnance_level5
object/tangible/ship/components/droid_interface/ddi_mandal_military_grade_mk2.iff	@cmd_n:cert_ordnance_levelten
object/tangible/ship/components/droid_interface/ddi_mission_reward_imperial_sfs_military_grade.iff	@cmd_n:cert_ordnance_level6
object/tangible/ship/components/droid_interface/ddi_mission_reward_neutral_sorosuub_w19.iff	@cmd_n:cert_ordnance_level4
object/tangible/ship/components/droid_interface/ddi_mission_reward_rebel_moncal_d22.iff	@cmd_n:cert_ordnance_level4
object/tangible/ship/components/droid_interface/ddi_mission_reward_rebel_novaldex_low_latency.iff	@cmd_n:cert_ordnance_level8
object/tangible/ship/components/droid_interface/ddi_moncal_advanced_interface.iff	@cmd_n:cert_ordnance_level9
object/tangible/ship/components/droid_interface/ddi_moncal_custom_dk2.iff	@cmd_n:cert_ordnance_level6
object/tangible/ship/components/droid_interface/ddi_moncal_dk1.iff	@cmd_n:cert_ordnance_level1
object/tangible/ship/components/droid_interface/ddi_moncal_dk2.iff	@cmd_n:cert_ordnance_level5
object/tangible/ship/components/droid_interface/ddi_moncal_dk3.iff	@cmd_n:cert_ordnance_level7
object/tangible/ship/components/droid_interface/ddi_moncal_dk4.iff	@cmd_n:cert_ordnance_level8
object/tangible/ship/components/droid_interface/ddi_moncal_elite.iff	@cmd_n:cert_ordnance_levelten
object/tangible/ship/components/droid_interface/ddi_moncal_special_dk1.iff	@cmd_n:cert_ordnance_level2
object/tangible/ship/components/droid_interface/ddi_novaldex_advanced_droid_interface.iff	@cmd_n:cert_ordnance_level9
object/tangible/ship/components/droid_interface/ddi_novaldex_custom_droid_interface_mk4.iff	@cmd_n:cert_ordnance_level8
object/tangible/ship/components/droid_interface/ddi_novaldex_droid_interface_mk1.iff	@cmd_n:cert_ordnance_level3
object/tangible/ship/components/droid_interface/ddi_novaldex_droid_interface_mk2.iff	@cmd_n:cert_ordnance_level5
object/tangible/ship/components/droid_interface/ddi_novaldex_droid_interface_mk3.iff	@cmd_n:cert_ordnance_level7
object/tangible/ship/components/droid_interface/ddi_novaldex_droid_interface_mk4.iff	@cmd_n:cert_ordnance_levelten
object/tangible/ship/components/droid_interface/ddi_novaldex_elite.iff	@cmd_n:cert_ordnance_levelten
object/tangible/ship/components/droid_interface/ddi_novaldex_special_droid_interface_mk1.iff	@cmd_n:cert_ordnance_level2
object/tangible/ship/components/droid_interface/ddi_qualdex_droid_interface_mk1.iff	@cmd_n:cert_ordnance_level2
object/tangible/ship/components/droid_interface/ddi_qualdex_droid_interface_mk2.iff	@cmd_n:cert_ordnance_level4
object/tangible/ship/components/droid_interface/ddi_qualdex_droid_interface_mk3.iff	@cmd_n:cert_ordnance_level6
object/tangible/ship/components/droid_interface/ddi_qualdex_droid_interface_mk4.iff	@cmd_n:cert_ordnance_level8
object/tangible/ship/components/droid_interface/ddi_qualdex_elite.iff	@cmd_n:cert_ordnance_levelten
object/tangible/ship/components/droid_interface/ddi_qualdex_enhanced_droid_interface_mk5.iff	@cmd_n:cert_ordnance_level9
object/tangible/ship/components/droid_interface/ddi_qualdex_modified_droid_interface_mk3.iff	@cmd_n:cert_ordnance_level7
object/tangible/ship/components/droid_interface/ddi_rendili_elite_imperator.iff	@cmd_n:cert_ordnance_level9
object/tangible/ship/components/droid_interface/ddi_rendili_imperator_1.iff	@cmd_n:cert_ordnance_level5
object/tangible/ship/components/droid_interface/ddi_rendili_imperator_2.iff	@cmd_n:cert_ordnance_level7
object/tangible/ship/components/droid_interface/ddi_rss_deluxe_imperial_2.iff	@cmd_n:cert_ordnance_level4
object/tangible/ship/components/droid_interface/ddi_rss_enhanced_imperial_1.iff	@cmd_n:cert_ordnance_level2
object/tangible/ship/components/droid_interface/ddi_rss_imperial_1.iff	@cmd_n:cert_ordnance_level1
object/tangible/ship/components/droid_interface/ddi_rss_imperial_2.iff	@cmd_n:cert_ordnance_level3
object/tangible/ship/components/droid_interface/ddi_sds_elite.iff	@cmd_n:cert_ordnance_levelten
object/tangible/ship/components/droid_interface/ddi_sds_enhanced_imperial_2.iff	@cmd_n:cert_ordnance_level6
object/tangible/ship/components/droid_interface/ddi_sds_imperial_1.iff	@cmd_n:cert_ordnance_level3
object/tangible/ship/components/droid_interface/ddi_sds_imperial_2.iff	@cmd_n:cert_ordnance_level5
object/tangible/ship/components/droid_interface/ddi_sds_imperial_3.iff	@cmd_n:cert_ordnance_level7
object/tangible/ship/components/droid_interface/ddi_sds_imperial_4.iff	@cmd_n:cert_ordnance_level8
object/tangible/ship/components/droid_interface/ddi_sds_imperial_5.iff	@cmd_n:cert_ordnance_level9
object/tangible/ship/components/droid_interface/ddi_sds_special_imperial_1.iff	@cmd_n:cert_ordnance_level4
object/tangible/ship/components/droid_interface/ddi_seinar_interface_mk1.iff	@cmd_n:cert_ordnance_level2
object/tangible/ship/components/droid_interface/ddi_seinar_interface_mk2.iff	@cmd_n:cert_ordnance_level4
object/tangible/ship/components/droid_interface/ddi_seinar_interface_mk3.iff	@cmd_n:cert_ordnance_level6
object/tangible/ship/components/droid_interface/ddi_seinar_interface_mk4.iff	@cmd_n:cert_ordnance_level9
object/tangible/ship/components/droid_interface/ddi_sfs_elite.iff	@cmd_n:cert_ordnance_levelten
object/tangible/ship/components/droid_interface/ddi_sfs_enhanced_imperial_1.iff	@cmd_n:cert_ordnance_level2
object/tangible/ship/components/droid_interface/ddi_sfs_imperial_1.iff	@cmd_n:cert_ordnance_level1
object/tangible/ship/components/droid_interface/ddi_sfs_imperial_2.iff	@cmd_n:cert_ordnance_level5
object/tangible/ship/components/droid_interface/ddi_sfs_imperial_3.iff	@cmd_n:cert_ordnance_level7
object/tangible/ship/components/droid_interface/ddi_sfs_imperial_mk5.iff	@cmd_n:cert_ordnance_level9
object/tangible/ship/components/droid_interface/ddi_sorosuub_echelon_1.iff	@cmd_n:cert_ordnance_level8
object/tangible/ship/components/droid_interface/ddi_sorosuub_echelon_2.iff	@cmd_n:cert_ordnance_level9
object/tangible/ship/components/droid_interface/ddi_sorosuub_elite.iff	@cmd_n:cert_ordnance_levelten
object/tangible/ship/components/droid_interface/ddi_sorosuub_enhanced_rad_mk1.iff	@cmd_n:cert_ordnance_level4
object/tangible/ship/components/droid_interface/ddi_sorosuub_modified_rad_mk2.iff	@cmd_n:cert_ordnance_level6
object/tangible/ship/components/droid_interface/ddi_sorosuub_rad_mk1.iff	@cmd_n:cert_ordnance_level3
object/tangible/ship/components/droid_interface/ddi_sorosuub_rad_mk2.iff	@cmd_n:cert_ordnance_level5
object/tangible/ship/components/droid_interface/ddi_sorosuub_rad_mk3.iff	@cmd_n:cert_ordnance_level7
object/tangible/ship/components/droid_interface/ddi_subpro_improved_jrd33.iff	@cmd_n:cert_ordnance_level4
object/tangible/ship/components/droid_interface/ddi_subpro_jrd33.iff	@cmd_n:cert_ordnance_level3
object/tangible/ship/components/droid_interface/ddi_tiefighter_basic.iff	@cmd_n:cert_ordnance_level1
object/tangible/ship/components/droid_interface/ddi_z95_basic.iff	@cmd_n:cert_ordnance_level1
object/tangible/ship/components/droid_interface/droid_interface_test.iff	@cmd_n:cert_ordnance_level1
object/tangible/ship/components/engine/eng_bezelbok_kessel_runner.iff	@cmd_n:cert_ordnance_level7
object/tangible/ship/components/engine/eng_corellian_cruiser_grade_mk1.iff	@cmd_n:cert_ordnance_level1
object/tangible/ship/components/engine/eng_corellian_cruiser_grade_mk2.iff	@cmd_n:cert_ordnance_level3
object/tangible/ship/components/engine/eng_corellian_deluxe_cruiser_grade_mk1.iff	@cmd_n:cert_ordnance_level2
object/tangible/ship/components/engine/eng_cygnus_hd_5.iff	@cmd_n:cert_ordnance_level2
object/tangible/ship/components/engine/eng_cygnus_hd3.iff	@cmd_n:cert_ordnance_level1
object/tangible/ship/components/engine/eng_cygnus_hd7.iff	@cmd_n:cert_ordnance_level3
object/tangible/ship/components/engine/eng_cygnus_hd8.iff	@cmd_n:cert_ordnance_level6
object/tangible/ship/components/engine/eng_cygnus_hdx.iff	@cmd_n:cert_ordnance_level8
object/tangible/ship/components/engine/eng_freitek_dual_jet.iff	@cmd_n:cert_ordnance_level7
object/tangible/ship/components/engine/eng_gallofree_advanced.iff	@cmd_n:cert_ordnance_level9
object/tangible/ship/components/engine/eng_gallofree_jx2.iff	@cmd_n:cert_ordnance_level1
object/tangible/ship/components/engine/eng_gallofree_jx3.iff	@cmd_n:cert_ordnance_level2
object/tangible/ship/components/engine/eng_generic.iff	@cmd_n:cert_ordnance_level1
object/tangible/ship/components/engine/eng_h17_singularity.iff	@cmd_n:cert_ordnance_level6
object/tangible/ship/components/engine/eng_haor_chall_old_engine.iff	@cmd_n:cert_ordnance_level1
object/tangible/ship/components/engine/eng_incom_advanced.iff	@cmd_n:cert_ordnance_level9
object/tangible/ship/components/engine/eng_incom_advanced_fusialthrust.iff	@cmd_n:cert_ordnance_level6
object/tangible/ship/components/engine/eng_incom_elite.iff	@cmd_n:cert_ordnance_levelten
object/tangible/ship/components/engine/eng_incom_fusialthrust.iff	@cmd_n:cert_ordnance_level4
object/tangible/ship/components/engine/eng_incom_fusialthrust_2.iff	@cmd_n:cert_ordnance_level7
object/tangible/ship/components/engine/eng_incom_heavy_fusialthrust.iff	@cmd_n:cert_ordnance_level5
object/tangible/ship/components/engine/eng_incom_improved_fusialthrust_2.iff	@cmd_n:cert_ordnance_level8
object/tangible/ship/components/engine/eng_incom_light_fusialthrust.iff	@cmd_n:cert_ordnance_level1
object/tangible/ship/components/engine/eng_kessel_imperial_rendili_hyperion_drive.iff	@cmd_n:cert_ordnance_level9
object/tangible/ship/components/engine/eng_kessel_imperial_sds_special_forces.iff	@cmd_n:cert_ordnance_levelten
object/tangible/ship/components/engine/eng_kessel_imperial_sfs_special_forces.iff	@cmd_n:cert_ordnance_level9
object/tangible/ship/components/engine/eng_kessel_rebel_incom_t11_elite.iff	@cmd_n:cert_ordnance_level9
object/tangible/ship/components/engine/eng_kessel_rebel_novaldex_blackhole_elite.iff	@cmd_n:cert_ordnance_levelten
object/tangible/ship/components/engine/eng_kessel_rebel_novaldex_grb1138.iff	@cmd_n:cert_ordnance_level9
object/tangible/ship/components/engine/eng_koensayr_advanced.iff	@cmd_n:cert_ordnance_level9
object/tangible/ship/components/engine/eng_koensayr_dual_small_ionjet.iff	@cmd_n:cert_ordnance_level3
object/tangible/ship/components/engine/eng_koensayr_elite.iff	@cmd_n:cert_ordnance_levelten
object/tangible/ship/components/engine/eng_koensayr_enhanced_dual_small_ionjet.iff	@cmd_n:cert_ordnance_level4
object/tangible/ship/components/engine/eng_koensayr_heavy_ionjet.iff	@cmd_n:cert_ordnance_level8
object/tangible/ship/components/engine/eng_koensayr_small_ionjet.iff	@cmd_n:cert_ordnance_level1
object/tangible/ship/components/engine/eng_koensayr_tuned_small_ionjet.iff	@cmd_n:cert_ordnance_level2
object/tangible/ship/components/engine/eng_kse_a2x.iff	@cmd_n:cert_ordnance_level1
object/tangible/ship/components/engine/eng_kse_a5x.iff	@cmd_n:cert_ordnance_level3
object/tangible/ship/components/engine/eng_kse_a7x.iff	@cmd_n:cert_ordnance_level5
object/tangible/ship/components/engine/eng_kse_a8x.iff	@cmd_n:cert_ordnance_level6
object/tangible/ship/components/engine/eng_kse_advanced.iff	@cmd_n:cert_ordnance_level9
object/tangible/ship/components/engine/eng_kse_elite.iff	@cmd_n:cert_ordnance_levelten
object/tangible/ship/components/engine/eng_kse_improved_a2x.iff	@cmd_n:cert_ordnance_level2
object/tangible/ship/components/engine/eng_kuat_m24.iff	@cmd_n:cert_ordnance_levelten
object/tangible/ship/components/engine/eng_mandal_advanced.iff	@cmd_n:cert_ordnance_level9
object/tangible/ship/components/engine/eng_mandal_elite.iff	@cmd_n:cert_ordnance_levelten
object/tangible/ship/components/engine/eng_mandal_enhanced_heavy.iff	@cmd_n:cert_ordnance_level6
object/tangible/ship/components/engine/eng_mandal_firestorm.iff	@cmd_n:cert_ordnance_level7
object/tangible/ship/components/engine/eng_mandal_firestorm_2.iff	@cmd_n:cert_ordnance_level8
object/tangible/ship/components/engine/eng_mandal_heavy.iff	@cmd_n:cert_ordnance_level5
object/tangible/ship/components/engine/eng_mandal_x37_vandal.iff	@cmd_n:cert_ordnance_level1
object/tangible/ship/components/engine/eng_mandal_x57_vandal.iff	@cmd_n:cert_ordnance_level4
object/tangible/ship/components/engine/eng_mission_reward_imperial_cygnus_megadrive.iff	@cmd_n:cert_ordnance_level6
object/tangible/ship/components/engine/eng_mission_reward_neutral_haor_chall_military.iff	@cmd_n:cert_ordnance_level8
object/tangible/ship/components/engine/eng_mission_reward_neutral_mandal_inferno.iff	@cmd_n:cert_ordnance_level6
object/tangible/ship/components/engine/eng_mission_reward_rebel_incom_military.iff	@cmd_n:cert_ordnance_level6
object/tangible/ship/components/engine/eng_moncal_charged_standard.iff	@cmd_n:cert_ordnance_level4
object/tangible/ship/components/engine/eng_moncal_enhanced_light.iff	@cmd_n:cert_ordnance_level2
object/tangible/ship/components/engine/eng_moncal_heavy.iff	@cmd_n:cert_ordnance_level5
object/tangible/ship/components/engine/eng_moncal_ifs32.iff	@cmd_n:cert_ordnance_level7
object/tangible/ship/components/engine/eng_moncal_ifs64.iff	@cmd_n:cert_ordnance_level8
object/tangible/ship/components/engine/eng_moncal_improved_heavy.iff	@cmd_n:cert_ordnance_level6
object/tangible/ship/components/engine/eng_moncal_light.iff	@cmd_n:cert_ordnance_level1
object/tangible/ship/components/engine/eng_moncal_standard.iff	@cmd_n:cert_ordnance_level3
object/tangible/ship/components/engine/eng_novaldex_advanced.iff	@cmd_n:cert_ordnance_level9
object/tangible/ship/components/engine/eng_novaldex_eventhorizon.iff	@cmd_n:cert_ordnance_level4
object/tangible/ship/components/engine/eng_novaldex_light_eventhorizon.iff	@cmd_n:cert_ordnance_level1
object/tangible/ship/components/engine/eng_novaldex_x6.iff	@cmd_n:cert_ordnance_level6
object/tangible/ship/components/engine/eng_novaldex_x7.iff	@cmd_n:cert_ordnance_level7
object/tangible/ship/components/engine/eng_novaldex_x9.iff	@cmd_n:cert_ordnance_level8
object/tangible/ship/components/engine/eng_prototype_engine.iff	@cmd_n:cert_ordnance_level1
object/tangible/ship/components/engine/eng_qualdex_a13.iff	@cmd_n:cert_ordnance_level6
object/tangible/ship/components/engine/eng_qualdex_advanced.iff	@cmd_n:cert_ordnance_level9
object/tangible/ship/components/engine/eng_qualdex_b10.iff	@cmd_n:cert_ordnance_level7
object/tangible/ship/components/engine/eng_qualdex_elite.iff	@cmd_n:cert_ordnance_levelten
object/tangible/ship/components/engine/eng_qualdex_kyromaster.iff	@cmd_n:cert_ordnance_level4
object/tangible/ship/components/engine/eng_qualdex_small_kyromaster.iff	@cmd_n:cert_ordnance_level1
object/tangible/ship/components/engine/eng_quantum_ion_drive.iff	@cmd_n:cert_ordnance_level8
object/tangible/ship/components/engine/eng_rendili_demon_mk1.iff	@cmd_n:cert_ordnance_level5
object/tangible/ship/components/engine/eng_rendili_elite.iff	@cmd_n:cert_ordnance_levelten
object/tangible/ship/components/engine/eng_reward_incom_elite.iff	@cmd_n:cert_ordnance_levelten
object/tangible/ship/components/engine/eng_reward_koensayr_elite.iff	@cmd_n:cert_ordnance_levelten
object/tangible/ship/components/engine/eng_reward_kuat_elite.iff	@cmd_n:cert_ordnance_levelten
object/tangible/ship/components/engine/eng_reward_novaldex_elite.iff	@cmd_n:cert_ordnance_levelten
object/tangible/ship/components/engine/eng_reward_surronian_elite.iff	@cmd_n:cert_ordnance_levelten
object/tangible/ship/components/engine/eng_rss_advanced.iff	@cmd_n:cert_ordnance_level9
object/tangible/ship/components/engine/eng_rss_elite.iff	@cmd_n:cert_ordnance_levelten
object/tangible/ship/components/engine/eng_rss_imperial_skyrunner.iff	@cmd_n:cert_ordnance_level4
object/tangible/ship/components/engine/eng_rss_imperial_skyrunner_2.iff	@cmd_n:cert_ordnance_level6
object/tangible/ship/components/engine/eng_rss_imperial_skyrunner_3.iff	@cmd_n:cert_ordnance_level7
object/tangible/ship/components/engine/eng_rss_imperial_skyrunner_4.iff	@cmd_n:cert_ordnance_level8
object/tangible/ship/components/engine/eng_sds_imperial_1.iff	@cmd_n:cert_ordnance_level1
object/tangible/ship/components/engine/eng_sds_imperial_2.iff	@cmd_n:cert_ordnance_level5
object/tangible/ship/components/engine/eng_sds_limited_imperial_1.iff	@cmd_n:cert_ordnance_level2
object/tangible/ship/components/engine/eng_sfs_advanced.iff	@cmd_n:cert_ordnance_level9
object/tangible/ship/components/engine/eng_sfs_elite.iff	@cmd_n:cert_ordnance_levelten
object/tangible/ship/components/engine/eng_sfs_imperial_1.iff	@cmd_n:cert_ordnance_level1
object/tangible/ship/components/engine/eng_sfs_imperial_2.iff	@cmd_n:cert_ordnance_level3
object/tangible/ship/components/engine/eng_sfs_imperial_3.iff	@cmd_n:cert_ordnance_level5
object/tangible/ship/components/engine/eng_sfs_imperial_4.iff	@cmd_n:cert_ordnance_level7
object/tangible/ship/components/engine/eng_sfs_imperial_5.iff	@cmd_n:cert_ordnance_level8
object/tangible/ship/components/engine/eng_sfs_modified_imperial_3.iff	@cmd_n:cert_ordnance_level6
object/tangible/ship/components/engine/eng_sfs_performance_imperial_1.iff	@cmd_n:cert_ordnance_level2
object/tangible/ship/components/engine/eng_sfs_tuned_imperial_2.iff	@cmd_n:cert_ordnance_level4
object/tangible/ship/components/engine/eng_sorosuub_l_337_ion_engine.iff	@cmd_n:cert_ordnance_level1
object/tangible/ship/components/engine/eng_sorosuub_tuned_l_337_ion_engine.iff	@cmd_n:cert_ordnance_level2
object/tangible/ship/components/engine/eng_sorosuub_u83r_ion_drive.iff	@cmd_n:cert_ordnance_level3
object/tangible/ship/components/engine/eng_subpro_light_engines.iff	@cmd_n:cert_ordnance_level1
object/tangible/ship/components/engine/eng_t86_shooting_star.iff	@cmd_n:cert_ordnance_level6
object/tangible/ship/components/engine/eng_tiefighter_basic.iff	@cmd_n:cert_ordnance_level1
object/tangible/ship/components/engine/eng_z95_basic.iff	@cmd_n:cert_ordnance_level1
object/tangible/ship/components/engine/engine_cygnus_hd7.iff	@cmd_n:cert_ordnance_level4
object/tangible/ship/components/engine/engine_damorian_rx7.iff	@cmd_n:cert_ordnance_level4
object/tangible/ship/components/engine/engine_incom_e16.iff	@cmd_n:cert_ordnance_level4
object/tangible/ship/components/engine/engine_incom_fusialthrust.iff	@cmd_n:cert_ordnance_level4
object/tangible/ship/components/engine/engine_koensayr_ionjet.iff	@cmd_n:cert_ordnance_level6
object/tangible/ship/components/engine/engine_kongar_defender.iff	@cmd_n:cert_ordnance_level4
object/tangible/ship/components/engine/engine_kuat_a9x.iff	@cmd_n:cert_ordnance_level7
object/tangible/ship/components/engine/engine_kuat_f31.iff	@cmd_n:cert_ordnance_level7
object/tangible/ship/components/engine/engine_kuat_tc40.iff	@cmd_n:cert_ordnance_level8
object/tangible/ship/components/engine/engine_novaldex_eventhorizon.iff	@cmd_n:cert_ordnance_level2
object/tangible/ship/components/engine/engine_novaldex_singularity.iff	@cmd_n:cert_ordnance_level5
object/tangible/ship/components/engine/engine_novaldex_x12.iff	@cmd_n:cert_ordnance_levelten
object/tangible/ship/components/engine/engine_nubian_221.iff	@cmd_n:cert_ordnance_level5
object/tangible/ship/components/engine/engine_nubian_221_racing_mod.iff	@cmd_n:cert_ordnance_levelten
object/tangible/ship/components/engine/engine_qualdex_a10.iff	@cmd_n:cert_ordnance_level5
object/tangible/ship/components/engine/engine_qualdex_igt.iff	@cmd_n:cert_ordnance_level8
object/tangible/ship/components/engine/engine_qualdex_kyromaster.iff	@cmd_n:cert_ordnance_level3
object/tangible/ship/components/engine/engine_seinar_ps56.iff	@cmd_n:cert_ordnance_level3
object/tangible/ship/components/engine/engine_surronian_a2.iff	@cmd_n:cert_ordnance_level2
object/tangible/ship/components/engine/engine_surronian_a25.iff	@cmd_n:cert_ordnance_level3
object/tangible/ship/components/engine/engine_test.iff	@cmd_n:cert_ordnance_level1
object/tangible/ship/components/engine/engine_ubrikkian_n2.iff	@cmd_n:cert_ordnance_level9
object/tangible/ship/components/engine/xwing_engine_s01_test.iff	@cmd_n:cert_ordnance_level1
object/tangible/ship/components/engine/xwing_engine_s02_test.iff	@cmd_n:cert_ordnance_level1
object/tangible/ship/components/reactor/rct_armek_phase_grinder.iff	@cmd_n:cert_ordnance_levelten
object/tangible/ship/components/reactor/rct_armek_super_collider.iff	@cmd_n:cert_ordnance_level8
object/tangible/ship/components/reactor/rct_armek_ultra_collider.iff	@cmd_n:cert_ordnance_level9
object/tangible/ship/components/reactor/rct_corellian_modified_bt3.iff	@cmd_n:cert_ordnance_levelten
object/tangible/ship/components/reactor/rct_corellian_modified_bt5.iff	@cmd_n:cert_ordnance_levelten
object/tangible/ship/components/reactor/rct_cygnus_advanced.iff	@cmd_n:cert_ordnance_level9
object/tangible/ship/components/reactor/rct_cygnus_mk1.iff	@cmd_n:cert_ordnance_level1
object/tangible/ship/components/reactor/rct_cygnus_mk2.iff	@cmd_n:cert_ordnance_level3
object/tangible/ship/components/reactor/rct_cygnus_supercharged_mk2.iff	@cmd_n:cert_ordnance_level4
object/tangible/ship/components/reactor/rct_cygnus_tuned_mk1.iff	@cmd_n:cert_ordnance_level2
object/tangible/ship/components/reactor/rct_freitek_improved_powerhouse_mk1.iff	@cmd_n:cert_ordnance_level4
object/tangible/ship/components/reactor/rct_freitek_level1.iff	@cmd_n:cert_ordnance_level1
object/tangible/ship/components/reactor/rct_freitek_performance_level1.iff	@cmd_n:cert_ordnance_level2
object/tangible/ship/components/reactor/rct_freitek_powerhouse_mk1.iff	@cmd_n:cert_ordnance_level3
object/tangible/ship/components/reactor/rct_freitek_powerhouse_mk2.iff	@cmd_n:cert_ordnance_level5
object/tangible/ship/components/reactor/rct_freitek_powerhouse_mk3.iff	@cmd_n:cert_ordnance_level8
object/tangible/ship/components/reactor/rct_generic.iff	@cmd_n:cert_ordnance_level1
object/tangible/ship/components/reactor/rct_incom_advanced.iff	@cmd_n:cert_ordnance_level9
object/tangible/ship/components/reactor/rct_incom_custom_mark2.iff	@cmd_n:cert_ordnance_level4
object/tangible/ship/components/reactor/rct_incom_elite.iff	@cmd_n:cert_ordnance_levelten
object/tangible/ship/components/reactor/rct_incom_improved_mark1.iff	@cmd_n:cert_ordnance_level2
object/tangible/ship/components/reactor/rct_incom_mark1.iff	@cmd_n:cert_ordnance_level1
object/tangible/ship/components/reactor/rct_incom_mark2.iff	@cmd_n:cert_ordnance_level3
object/tangible/ship/components/reactor/rct_incom_mark3.iff	@cmd_n:cert_ordnance_level5
object/tangible/ship/components/reactor/rct_incom_mark4.iff	@cmd_n:cert_ordnance_level7
object/tangible/ship/components/reactor/rct_incom_mark5.iff	@cmd_n:cert_ordnance_level8
object/tangible/ship/components/reactor/rct_kessel_imperial_kdy_powermaster.iff	@cmd_n:cert_ordnance_level9
object/tangible/ship/components/reactor/rct_kessel_imperial_sds_secret_ops.iff	@cmd_n:cert_ordnance_levelten
object/tangible/ship/components/reactor/rct_kessel_imperial_sfs_special_forces.iff	@cmd_n:cert_ordnance_level9
object/tangible/ship/components/reactor/rct_kessel_rebel_incom_overdriven_elite.iff	@cmd_n:cert_ordnance_level9
object/tangible/ship/components/reactor/rct_kessel_rebel_mandal_modified_gorax.iff	@cmd_n:cert_ordnance_level9
object/tangible/ship/components/reactor/rct_kessel_rebel_slayn_high_output_experimental.iff	@cmd_n:cert_ordnance_levelten
object/tangible/ship/components/reactor/rct_koensayr_charged_supernova.iff	@cmd_n:cert_ordnance_level2
object/tangible/ship/components/reactor/rct_koensayr_enhanced_supernova_mk2.iff	@cmd_n:cert_ordnance_level4
object/tangible/ship/components/reactor/rct_koensayr_supernova.iff	@cmd_n:cert_ordnance_level1
object/tangible/ship/components/reactor/rct_koensayr_supernova_advanced.iff	@cmd_n:cert_ordnance_level7
object/tangible/ship/components/reactor/rct_koensayr_supernova_mk2.iff	@cmd_n:cert_ordnance_level3
object/tangible/ship/components/reactor/rct_koensayr_supernova_mk3.iff	@cmd_n:cert_ordnance_level5
object/tangible/ship/components/reactor/rct_krayt_neverdie.iff	@cmd_n:cert_ordnance_level7
object/tangible/ship/components/reactor/rct_kse_custom_lx11.iff	@cmd_n:cert_ordnance_level2
object/tangible/ship/components/reactor/rct_kse_lx11.iff	@cmd_n:cert_ordnance_level1
object/tangible/ship/components/reactor/rct_kse_lx21.iff	@cmd_n:cert_ordnance_level3
object/tangible/ship/components/reactor/rct_kse_rct_x.iff	@cmd_n:cert_ordnance_level4
object/tangible/ship/components/reactor/rct_kse_rct_z.iff	@cmd_n:cert_ordnance_level8
object/tangible/ship/components/reactor/rct_kse_supreme.iff	@cmd_n:cert_ordnance_level9
object/tangible/ship/components/reactor/rct_mandal_dx_advanced.iff	@cmd_n:cert_ordnance_level9
object/tangible/ship/components/reactor/rct_mandal_dxr.iff	@cmd_n:cert_ordnance_level1
object/tangible/ship/components/reactor/rct_mandal_dxr2.iff	@cmd_n:cert_ordnance_level2
object/tangible/ship/components/reactor/rct_mandal_dxr3.iff	@cmd_n:cert_ordnance_level3
object/tangible/ship/components/reactor/rct_mandal_dxr4.iff	@cmd_n:cert_ordnance_level4
object/tangible/ship/components/reactor/rct_mandal_dxr5.iff	@cmd_n:cert_ordnance_level7
object/tangible/ship/components/reactor/rct_mandal_dxr6.iff	@cmd_n:cert_ordnance_level6
object/tangible/ship/components/reactor/rct_mandalor_gorax.iff	@cmd_n:cert_ordnance_level9
object/tangible/ship/components/reactor/rct_mandalor_gorax_elite.iff	@cmd_n:cert_ordnance_levelten
object/tangible/ship/components/reactor/rct_mission_reward_imperial_rss_advanced_military.iff	@cmd_n:cert_ordnance_level8
object/tangible/ship/components/reactor/rct_mission_reward_imperial_sds_high_output.iff	@cmd_n:cert_ordnance_level6
object/tangible/ship/components/reactor/rct_mission_reward_neutral_subpro_military.iff	@cmd_n:cert_ordnance_level6
object/tangible/ship/components/reactor/rct_mission_reward_rebel_slayn_hypervortex.iff	@cmd_n:cert_ordnance_level6
object/tangible/ship/components/reactor/rct_moncal_overdriver_s1.iff	@cmd_n:cert_ordnance_levelten
object/tangible/ship/components/reactor/rct_moncal_overdriver_s2.iff	@cmd_n:cert_ordnance_level6
object/tangible/ship/components/reactor/rct_prototype_reactor.iff	@cmd_n:cert_ordnance_level1
object/tangible/ship/components/reactor/rct_rendili_type_x_elite.iff	@cmd_n:cert_ordnance_levelten
object/tangible/ship/components/reactor/rct_rendili_type5.iff	@cmd_n:cert_ordnance_level5
object/tangible/ship/components/reactor/rct_rendili_type7.iff	@cmd_n:cert_ordnance_level7
object/tangible/ship/components/reactor/rct_reward_armek_elite.iff	@cmd_n:cert_ordnance_levelten
object/tangible/ship/components/reactor/rct_reward_incom_elite.iff	@cmd_n:cert_ordnance_levelten
object/tangible/ship/components/reactor/rct_reward_slayn_elite.iff	@cmd_n:cert_ordnance_levelten
object/tangible/ship/components/reactor/rct_reward_subpro_elite.iff	@cmd_n:cert_ordnance_levelten
object/tangible/ship/components/reactor/rct_reward_taim_elite.iff	@cmd_n:cert_ordnance_levelten
object/tangible/ship/components/reactor/rct_rss_advanced.iff	@cmd_n:cert_ordnance_level9
object/tangible/ship/components/reactor/rct_rss_x12.iff	@cmd_n:cert_ordnance_level7
object/tangible/ship/components/reactor/rct_rss_x8.iff	@cmd_n:cert_ordnance_level6
object/tangible/ship/components/reactor/rct_sds_elite.iff	@cmd_n:cert_ordnance_levelten
object/tangible/ship/components/reactor/rct_sds_imperial_1.iff	@cmd_n:cert_ordnance_level5
object/tangible/ship/components/reactor/rct_sds_special_forces_1.iff	@cmd_n:cert_ordnance_level8
object/tangible/ship/components/reactor/rct_seinar_enhanced_level1.iff	@cmd_n:cert_ordnance_level2
object/tangible/ship/components/reactor/rct_seinar_level1.iff	@cmd_n:cert_ordnance_level1
object/tangible/ship/components/reactor/rct_seinar_level2.iff	@cmd_n:cert_ordnance_level3
object/tangible/ship/components/reactor/rct_seinar_level3.iff	@cmd_n:cert_ordnance_level5
object/tangible/ship/components/reactor/rct_seinar_level4.iff	@cmd_n:cert_ordnance_level7
object/tangible/ship/components/reactor/rct_sfs_advanced.iff	@cmd_n:cert_ordnance_level9
object/tangible/ship/components/reactor/rct_sfs_elite.iff	@cmd_n:cert_ordnance_levelten
object/tangible/ship/components/reactor/rct_sfs_imperial_1.iff	@cmd_n:cert_ordnance_level3
object/tangible/ship/components/reactor/rct_sfs_imperial_2.iff	@cmd_n:cert_ordnance_level4
object/tangible/ship/components/reactor/rct_sfs_imperial_3.iff	@cmd_n:cert_ordnance_level5
object/tangible/ship/components/reactor/rct_sfs_imperial_4.iff	@cmd_n:cert_ordnance_level6
object/tangible/ship/components/reactor/rct_sfs_imperial_5.iff	@cmd_n:cert_ordnance_level8
object/tangible/ship/components/reactor/rct_slayn_hypertron_2k.iff	@cmd_n:cert_ordnance_level5
object/tangible/ship/components/reactor/rct_slayn_hypertron_4k.iff	@cmd_n:cert_ordnance_levelten
object/tangible/ship/components/reactor/rct_slayn_vortex_mk1.iff	@cmd_n:cert_ordnance_level3
object/tangible/ship/components/reactor/rct_slayn_vortex_mk2.iff	@cmd_n:cert_ordnance_level6
object/tangible/ship/components/reactor/rct_slayn_vortex_mk3.iff	@cmd_n:cert_ordnance_level7
object/tangible/ship/components/reactor/rct_slayn_vortex_mk4.iff	@cmd_n:cert_ordnance_level8
object/tangible/ship/components/reactor/rct_sorosuub_fusion_reactor_1.iff	@cmd_n:cert_ordnance_level3
object/tangible/ship/components/reactor/rct_sorosuub_fusion_reactor_2.iff	@cmd_n:cert_ordnance_level4
object/tangible/ship/components/reactor/rct_sorosuub_fusion_reactor_3.iff	@cmd_n:cert_ordnance_level5
object/tangible/ship/components/reactor/rct_sorosuub_turbine_3.iff	@cmd_n:cert_ordnance_level7
object/tangible/ship/components/reactor/rct_sorosuub_turbine_advanced.iff	@cmd_n:cert_ordnance_level9
object/tangible/ship/components/reactor/rct_subpro_aurora.iff	@cmd_n:cert_ordnance_level6
object/tangible/ship/components/reactor/rct_subpro_aurora_max.iff	@cmd_n:cert_ordnance_level7
object/tangible/ship/components/reactor/rct_subpro_dyna1.iff	@cmd_n:cert_ordnance_level1
object/tangible/ship/components/reactor/rct_subpro_dyna2.iff	@cmd_n:cert_ordnance_level8
object/tangible/ship/components/reactor/rct_subpro_special_dyna2.iff	@cmd_n:cert_ordnance_level2
object/tangible/ship/components/reactor/rct_taim_experimental_s1.iff	@cmd_n:cert_ordnance_level6
object/tangible/ship/components/reactor/rct_taim_experimental_s2.iff	@cmd_n:cert_ordnance_level8
object/tangible/ship/components/reactor/rct_taim_experimental_s3.iff	@cmd_n:cert_ordnance_level7
object/tangible/ship/components/reactor/rct_tiefighter_basic.iff	@cmd_n:cert_ordnance_level1
object/tangible/ship/components/reactor/rct_tiefighter_basic.iff	@cmd_n:cert_ordnance_level1
object/tangible/ship/components/reactor/rct_unknown_distressed_aluminum.iff	@cmd_n:cert_ordnance_level6
object/tangible/ship/components/reactor/rct_unknown_multicore.iff	@cmd_n:cert_ordnance_level6
object/tangible/ship/components/reactor/rct_unknown_proton_chamber.iff	@cmd_n:cert_ordnance_level6
object/tangible/ship/components/reactor/rct_watto_sunray_2.iff	@cmd_n:cert_ordnance_level2
object/tangible/ship/components/reactor/rct_watto_sunray_3.iff	@cmd_n:cert_ordnance_level4
object/tangible/ship/components/reactor/rct_z95_basic.iff	@cmd_n:cert_ordnance_level1
object/tangible/ship/components/reactor/rct_z95_basic.iff	@cmd_n:cert_ordnance_level1
object/tangible/ship/components/reactor/reactor_test.iff	@cmd_n:cert_ordnance_level1
object/tangible/ship/components/shield_generator/shd_armek_plasma_shell_elite.iff	@cmd_n:cert_ordnance_level9
object/tangible/ship/components/shield_generator/shd_armek_plasma_shell_elite_2.iff	@cmd_n:cert_ordnance_levelten
object/tangible/ship/components/shield_generator/shd_armek_plasma_shell_s1.iff	@cmd_n:cert_ordnance_level1
object/tangible/ship/components/shield_generator/shd_armek_plasma_shell_s2.iff	@cmd_n:cert_ordnance_level2
object/tangible/ship/components/shield_generator/shd_armek_plasma_shell_s3.iff	@cmd_n:cert_ordnance_level4
object/tangible/ship/components/shield_generator/shd_armek_plasma_shell_s6.iff	@cmd_n:cert_ordnance_level6
object/tangible/ship/components/shield_generator/shd_cygnus_elite.iff	@cmd_n:cert_ordnance_levelten
object/tangible/ship/components/shield_generator/shd_cygnus_improved_mk2.iff	@cmd_n:cert_ordnance_level5
object/tangible/ship/components/shield_generator/shd_cygnus_mk1.iff	@cmd_n:cert_ordnance_level1
object/tangible/ship/components/shield_generator/shd_cygnus_mk2.iff	@cmd_n:cert_ordnance_level4
object/tangible/ship/components/shield_generator/shd_cygnus_mk3.iff	@cmd_n:cert_ordnance_level6
object/tangible/ship/components/shield_generator/shd_cygnus_mk4.iff	@cmd_n:cert_ordnance_level7
object/tangible/ship/components/shield_generator/shd_cygnus_mk5.iff	@cmd_n:cert_ordnance_level9
object/tangible/ship/components/shield_generator/shd_cygnus_special_mk1.iff	@cmd_n:cert_ordnance_level2
object/tangible/ship/components/shield_generator/shd_dual_deflector_s1.iff	@cmd_n:cert_ordnance_level1
object/tangible/ship/components/shield_generator/shd_dual_deflector_s2.iff	@cmd_n:cert_ordnance_level1
object/tangible/ship/components/shield_generator/shd_esp_reactive.iff	@cmd_n:cert_ordnance_level6
object/tangible/ship/components/shield_generator/shd_gallofree_defender_2.iff	@cmd_n:cert_ordnance_level8
object/tangible/ship/components/shield_generator/shd_gallofree_defender_elite.iff	@cmd_n:cert_ordnance_levelten
object/tangible/ship/components/shield_generator/shd_generic.iff	@cmd_n:cert_ordnance_level1
object/tangible/ship/components/shield_generator/shd_incom_mark2.iff	@cmd_n:cert_ordnance_level1
object/tangible/ship/components/shield_generator/shd_incom_mark5.iff	@cmd_n:cert_ordnance_level1
object/tangible/ship/components/shield_generator/shd_incom_mark9.iff	@cmd_n:cert_ordnance_level1
object/tangible/ship/components/shield_generator/shd_incom_rayshield_advanced.iff	@cmd_n:cert_ordnance_level7
object/tangible/ship/components/shield_generator/shd_incom_rayshield_r4.iff	@cmd_n:cert_ordnance_level2
object/tangible/ship/components/shield_generator/shd_incom_rayshield_r7.iff	@cmd_n:cert_ordnance_level2
object/tangible/ship/components/shield_generator/shd_incom_rayshield_x1.iff	@cmd_n:cert_ordnance_level3
object/tangible/ship/components/shield_generator/shd_incom_rayshield_x12.iff	@cmd_n:cert_ordnance_level5
object/tangible/ship/components/shield_generator/shd_incom_rayshield_x2.iff	@cmd_n:cert_ordnance_level3
object/tangible/ship/components/shield_generator/shd_incom_rayshield_x5.iff	@cmd_n:cert_ordnance_level3
object/tangible/ship/components/shield_generator/shd_incom_rayshield_x7.iff	@cmd_n:cert_ordnance_level4
object/tangible/ship/components/shield_generator/shd_incom_rayshield_x9.iff	@cmd_n:cert_ordnance_level4
object/tangible/ship/components/shield_generator/shd_incom_rayshield_z1.iff	@cmd_n:cert_ordnance_level5
object/tangible/ship/components/shield_generator/shd_incom_rayshield_z5.iff	@cmd_n:cert_ordnance_level6
object/tangible/ship/components/shield_generator/shd_incom_rayshield_z7.iff	@cmd_n:cert_ordnance_level6
object/tangible/ship/components/shield_generator/shd_incom_techscreen_1.iff	@cmd_n:cert_ordnance_level8
object/tangible/ship/components/shield_generator/shd_incom_techscreen_2.iff	@cmd_n:cert_ordnance_level9
object/tangible/ship/components/shield_generator/shd_incom_techscreen_elite.iff	@cmd_n:cert_ordnance_levelten
object/tangible/ship/components/shield_generator/shd_interlaced_graviton.iff	@cmd_n:cert_ordnance_level9
object/tangible/ship/components/shield_generator/shd_kessel_imperial_cygnus_experimental_system.iff	@cmd_n:cert_ordnance_level9
object/tangible/ship/components/shield_generator/shd_kessel_imperial_sds_secret_ops.iff	@cmd_n:cert_ordnance_levelten
object/tangible/ship/components/shield_generator/shd_kessel_imperial_sfs_megapolyweb.iff	@cmd_n:cert_ordnance_level9
object/tangible/ship/components/shield_generator/shd_kessel_rebel_incom_rayshield_overdriver.iff	@cmd_n:cert_ordnance_level9
object/tangible/ship/components/shield_generator/shd_kessel_rebel_sorosuub_ion_mesh_projection.iff	@cmd_n:cert_ordnance_levelten
object/tangible/ship/components/shield_generator/shd_kessel_rebel_unknown_proton_interweave_system.iff	@cmd_n:cert_ordnance_level9
object/tangible/ship/components/shield_generator/shd_koensayr_deflector_advanced.iff	@cmd_n:cert_ordnance_level8
object/tangible/ship/components/shield_generator/shd_koensayr_deflector_elite.iff	@cmd_n:cert_ordnance_levelten
object/tangible/ship/components/shield_generator/shd_koensayr_deflector_m1.iff	@cmd_n:cert_ordnance_level1
object/tangible/ship/components/shield_generator/shd_koensayr_deflector_m2.iff	@cmd_n:cert_ordnance_level3
object/tangible/ship/components/shield_generator/shd_koensayr_deflector_m3.iff	@cmd_n:cert_ordnance_level5
object/tangible/ship/components/shield_generator/shd_koensayr_deflector_m6.iff	@cmd_n:cert_ordnance_level6
object/tangible/ship/components/shield_generator/shd_koensayr_deflector_m8.iff	@cmd_n:cert_ordnance_level7
object/tangible/ship/components/shield_generator/shd_koensayr_improved_deflector_m1.iff	@cmd_n:cert_ordnance_level2
object/tangible/ship/components/shield_generator/shd_koensayr_modified_deflector_advanced.iff	@cmd_n:cert_ordnance_level9
object/tangible/ship/components/shield_generator/shd_kse_elite.iff	@cmd_n:cert_ordnance_levelten
object/tangible/ship/components/shield_generator/shd_kse_enhanced_military_mk1.iff	@cmd_n:cert_ordnance_level2
object/tangible/ship/components/shield_generator/shd_kse_military_mk1.iff	@cmd_n:cert_ordnance_level1
object/tangible/ship/components/shield_generator/shd_kse_military_mk2.iff	@cmd_n:cert_ordnance_level3
object/tangible/ship/components/shield_generator/shd_kse_mk3.iff	@cmd_n:cert_ordnance_level5
object/tangible/ship/components/shield_generator/shd_kse_mk4.iff	@cmd_n:cert_ordnance_level6
object/tangible/ship/components/shield_generator/shd_kse_mk5.iff	@cmd_n:cert_ordnance_level7
object/tangible/ship/components/shield_generator/shd_kse_mk6.iff	@cmd_n:cert_ordnance_level8
object/tangible/ship/components/shield_generator/shd_kse_mk7.iff	@cmd_n:cert_ordnance_level9
object/tangible/ship/components/shield_generator/shd_mandal_double_protector_mk1.iff	@cmd_n:cert_ordnance_level2
object/tangible/ship/components/shield_generator/shd_mandal_flexshield_ks25.iff	@cmd_n:cert_ordnance_level6
object/tangible/ship/components/shield_generator/shd_mandal_flexshield_ks5.iff	@cmd_n:cert_ordnance_level5
object/tangible/ship/components/shield_generator/shd_mandal_flexshield_ks7.iff	@cmd_n:cert_ordnance_level7
object/tangible/ship/components/shield_generator/shd_mandal_flexshield_kx1.iff	@cmd_n:cert_ordnance_level8
object/tangible/ship/components/shield_generator/shd_mandal_protector_mk1.iff	@cmd_n:cert_ordnance_level1
object/tangible/ship/components/shield_generator/shd_mandalor_flexshield_ks1.iff	@cmd_n:cert_ordnance_level3
object/tangible/ship/components/shield_generator/shd_mandalor_flexshield_ks18.iff	@cmd_n:cert_ordnance_level5
object/tangible/ship/components/shield_generator/shd_mandalor_flexshield_ks3.iff	@cmd_n:cert_ordnance_level4
object/tangible/ship/components/shield_generator/shd_mission_reward_imperial_cygnus_holoscreen.iff	@cmd_n:cert_ordnance_level8
object/tangible/ship/components/shield_generator/shd_mission_reward_imperial_rendili_dual_projector.iff	@cmd_n:cert_ordnance_level4
object/tangible/ship/components/shield_generator/shd_mission_reward_neutral_armek_plasma_web.iff	@cmd_n:cert_ordnance_level8
object/tangible/ship/components/shield_generator/shd_mission_reward_neutral_koensayr_ds23.iff	@cmd_n:cert_ordnance_level4
object/tangible/ship/components/shield_generator/shd_mission_reward_rebel_incom_k77.iff	@cmd_n:cert_ordnance_level4
object/tangible/ship/components/shield_generator/shd_mission_reward_rebel_taim_military_grade.iff	@cmd_n:cert_ordnance_level8
object/tangible/ship/components/shield_generator/shd_moncal.iff	@cmd_n:cert_ordnance_level4
object/tangible/ship/components/shield_generator/shd_moncal_deluxe_ionweb_a.iff	@cmd_n:cert_ordnance_level2
object/tangible/ship/components/shield_generator/shd_moncal_deluxe_ionweb_b.iff	@cmd_n:cert_ordnance_level3
object/tangible/ship/components/shield_generator/shd_moncal_ionweb_a.iff	@cmd_n:cert_ordnance_level1
object/tangible/ship/components/shield_generator/shd_moncal_ionweb_advanced.iff	@cmd_n:cert_ordnance_level8
object/tangible/ship/components/shield_generator/shd_moncal_ionweb_elite.iff	@cmd_n:cert_ordnance_level9
object/tangible/ship/components/shield_generator/shd_moncal_ionweb_elite_2.iff	@cmd_n:cert_ordnance_levelten
object/tangible/ship/components/shield_generator/shd_moncal_ionweb_heavy.iff	@cmd_n:cert_ordnance_level7
object/tangible/ship/components/shield_generator/shd_phased_fullerine_fx12.iff	@cmd_n:cert_ordnance_level6
object/tangible/ship/components/shield_generator/shd_phased_fullerine_fx27.iff	@cmd_n:cert_ordnance_level7
object/tangible/ship/components/shield_generator/shd_phased_fullerine_fx92.iff	@cmd_n:cert_ordnance_level8
object/tangible/ship/components/shield_generator/shd_protecto_net.iff	@cmd_n:cert_ordnance_level8
object/tangible/ship/components/shield_generator/shd_prototype_shield.iff	@cmd_n:cert_ordnance_level1
object/tangible/ship/components/shield_generator/shd_rendili.iff	@cmd_n:cert_ordnance_level4
object/tangible/ship/components/shield_generator/shd_reward_armek_elite.iff	@cmd_n:cert_ordnance_levelten
object/tangible/ship/components/shield_generator/shd_reward_incom_elite.iff	@cmd_n:cert_ordnance_levelten
object/tangible/ship/components/shield_generator/shd_reward_mandalor_elite.iff	@cmd_n:cert_ordnance_levelten
object/tangible/ship/components/shield_generator/shd_reward_seinar_elite.iff	@cmd_n:cert_ordnance_levelten
object/tangible/ship/components/shield_generator/shd_reward_taim_elite.iff	@cmd_n:cert_ordnance_levelten
object/tangible/ship/components/shield_generator/shd_seinar_experimental_a1.iff	@cmd_n:cert_ordnance_level3
object/tangible/ship/components/shield_generator/shd_seinar_gx_elite.iff	@cmd_n:cert_ordnance_level1
object/tangible/ship/components/shield_generator/shd_seinar_gx3.iff	@cmd_n:cert_ordnance_level1
object/tangible/ship/components/shield_generator/shd_seinar_gx7.iff	@cmd_n:cert_ordnance_level1
object/tangible/ship/components/shield_generator/shd_seinar_proton_screen_p1.iff	@cmd_n:cert_ordnance_level2
object/tangible/ship/components/shield_generator/shd_seinar_proton_screen_p6.iff	@cmd_n:cert_ordnance_level2
object/tangible/ship/components/shield_generator/shd_seinar_reflector_elite.iff	@cmd_n:cert_ordnance_level3
object/tangible/ship/components/shield_generator/shd_seinar_reflector_standard.iff	@cmd_n:cert_ordnance_level3
object/tangible/ship/components/shield_generator/shd_sfs_advanced.iff	@cmd_n:cert_ordnance_level6
object/tangible/ship/components/shield_generator/shd_sfs_custom_polyweb_elite.iff	@cmd_n:cert_ordnance_levelten
object/tangible/ship/components/shield_generator/shd_sfs_imperial_deluxe_standard.iff	@cmd_n:cert_ordnance_level4
object/tangible/ship/components/shield_generator/shd_sfs_imperial_heavy.iff	@cmd_n:cert_ordnance_level5
object/tangible/ship/components/shield_generator/shd_sfs_imperial_special_forces.iff	@cmd_n:cert_ordnance_level7
object/tangible/ship/components/shield_generator/shd_sfs_imperial_standard.iff	@cmd_n:cert_ordnance_level4
object/tangible/ship/components/shield_generator/shd_sfs_limited_advanced.iff	@cmd_n:cert_ordnance_level6
object/tangible/ship/components/shield_generator/shd_sfs_modified_imperial_heavy.iff	@cmd_n:cert_ordnance_level5
object/tangible/ship/components/shield_generator/shd_sfs_modified_imperial_special_forces.iff	@cmd_n:cert_ordnance_level7
object/tangible/ship/components/shield_generator/shd_sfs_modified_polyweb_advanced.iff	@cmd_n:cert_ordnance_level9
object/tangible/ship/components/shield_generator/shd_sfs_polyweb_4.iff	@cmd_n:cert_ordnance_level8
object/tangible/ship/components/shield_generator/shd_sfs_polyweb_6.iff	@cmd_n:cert_ordnance_level8
object/tangible/ship/components/shield_generator/shd_sfs_polyweb_advanced.iff	@cmd_n:cert_ordnance_level9
object/tangible/ship/components/shield_generator/shd_sfs_polyweb_elite.iff	@cmd_n:cert_ordnance_levelten
object/tangible/ship/components/shield_generator/shd_shd_moncal_ionweb_prototype_b.iff	@cmd_n:cert_ordnance_level6
object/tangible/ship/components/shield_generator/shd_taim_advanced.iff	@cmd_n:cert_ordnance_level8
object/tangible/ship/components/shield_generator/shd_taim_elite.iff	@cmd_n:cert_ordnance_levelten
object/tangible/ship/components/shield_generator/shd_taim_enhanced_advanced.iff	@cmd_n:cert_ordnance_level9
object/tangible/ship/components/shield_generator/shd_taim_heavy.iff	@cmd_n:cert_ordnance_level7
object/tangible/ship/components/shield_generator/shd_taim_standard.iff	@cmd_n:cert_ordnance_level4
object/tangible/ship/components/shield_generator/shd_taim_torton.iff	@cmd_n:cert_ordnance_levelten
object/tangible/ship/components/shield_generator/shd_tiefighter_basic.iff	@cmd_n:cert_ordnance_level1
object/tangible/ship/components/shield_generator/shd_unknown_holosteel_x1.iff	@cmd_n:cert_ordnance_level3
object/tangible/ship/components/shield_generator/shd_unknown_holosteel_x2.iff	@cmd_n:cert_ordnance_level3
object/tangible/ship/components/shield_generator/shd_unknown_proton_projector.iff	@cmd_n:cert_ordnance_level2
object/tangible/ship/components/shield_generator/shd_z95_basic.iff	@cmd_n:cert_ordnance_level1
object/tangible/ship/components/shield_generator/shield_generator_test.iff	@cmd_n:cert_ordnance_level1
object/tangible/ship/components/weapon/weapon_incom_disruptor.iff	@cmd_n:cert_ordnance_level3
object/tangible/ship/components/weapon/weapon_slayn_ioncannon.iff	@cmd_n:cert_ordnance_level2
object/tangible/ship/components/weapon/weapon_subpro_tripleblaster.iff	@cmd_n:cert_ordnance_level4
object/tangible/ship/components/weapon/wpn_armek_advanced.iff	@cmd_n:cert_ordnance_level9
object/tangible/ship/components/weapon/wpn_armek_elite.iff	@cmd_n:cert_ordnance_levelten
object/tangible/ship/components/weapon/wpn_armek_sw4.iff	@cmd_n:cert_ordnance_level5
object/tangible/ship/components/weapon/wpn_armek_sw6.iff	@cmd_n:cert_ordnance_level6
object/tangible/ship/components/weapon/wpn_armek_sw7.iff	@cmd_n:cert_ordnance_level8
object/tangible/ship/components/weapon/wpn_armek_sw8.iff	@cmd_n:cert_ordnance_level7
object/tangible/ship/components/weapon/wpn_awing_blaster.iff	@cmd_n:cert_ordnance_level2
object/tangible/ship/components/weapon/wpn_borstel_rg9.iff	@cmd_n:cert_ordnance_level9
object/tangible/ship/components/weapon/wpn_bwing_blaster.iff	@cmd_n:cert_ordnance_level2
object/tangible/ship/components/weapon/wpn_capitalship_turret_test.iff	@cmd_n:cert_ordnance_level3
object/tangible/ship/components/weapon/wpn_corellian_1d.iff	@cmd_n:cert_ordnance_level7
object/tangible/ship/components/weapon/wpn_corellian_ag1g_laser.iff	@cmd_n:cert_ordnance_level8
object/tangible/ship/components/weapon/wpn_corellian_ag2g_quad_laser.iff	@cmd_n:cert_ordnance_levelten
object/tangible/ship/components/weapon/wpn_corellian_cruiser_grade_blaster_mk1.iff	@cmd_n:cert_ordnance_level1
object/tangible/ship/components/weapon/wpn_corellian_heavy_gauss.iff	@cmd_n:cert_ordnance_levelten
object/tangible/ship/components/weapon/wpn_corvette_turret_sm_s01.iff	@cmd_n:cert_ordnance_level3
object/tangible/ship/components/weapon/wpn_cygnus_destroyer_mk1.iff	@cmd_n:cert_ordnance_level1
object/tangible/ship/components/weapon/wpn_cygnus_destroyer_mk2.iff	@cmd_n:cert_ordnance_level3
object/tangible/ship/components/weapon/wpn_cygnus_elite.iff	@cmd_n:cert_ordnance_levelten
object/tangible/ship/components/weapon/wpn_cygnus_eradicator_1.iff	@cmd_n:cert_ordnance_level8
object/tangible/ship/components/weapon/wpn_fastspray_2000_disruptor.iff	@cmd_n:cert_ordnance_level6
object/tangible/ship/components/weapon/wpn_freitek_cannoneer_mk1.iff	@cmd_n:cert_ordnance_level3
object/tangible/ship/components/weapon/wpn_generic.iff	@cmd_n:cert_ordnance_level4
object/tangible/ship/components/weapon/wpn_gyrhil_auto_blaster.iff	@cmd_n:cert_ordnance_level8
object/tangible/ship/components/weapon/wpn_gyrhil_r9x.iff	@cmd_n:cert_ordnance_levelten
object/tangible/ship/components/weapon/wpn_haor_chall_speedblaster.iff	@cmd_n:cert_ordnance_level3
object/tangible/ship/components/weapon/wpn_heavy_ionic_pulse_weapon.iff	@cmd_n:cert_ordnance_levelten
object/tangible/ship/components/weapon/wpn_hk_modified_scorcher_elite.iff	@cmd_n:cert_ordnance_levelten
object/tangible/ship/components/weapon/wpn_hk_scorcher.iff	@cmd_n:cert_ordnance_level4
object/tangible/ship/components/weapon/wpn_hk_scorcher_2.iff	@cmd_n:cert_ordnance_level5
object/tangible/ship/components/weapon/wpn_hk_scorcher_3.iff	@cmd_n:cert_ordnance_level6
object/tangible/ship/components/weapon/wpn_hk_scorcher_advanced.iff	@cmd_n:cert_ordnance_level8
object/tangible/ship/components/weapon/wpn_hk_scorcher_elite.iff	@cmd_n:cert_ordnance_level9
object/tangible/ship/components/weapon/wpn_hk_scorcher_heavy.iff	@cmd_n:cert_ordnance_level7
object/tangible/ship/components/weapon/wpn_hoersch_railgun.iff	@cmd_n:cert_ordnance_levelten
object/tangible/ship/components/weapon/wpn_incom_advanced_blaster.iff	@cmd_n:cert_ordnance_level6
object/tangible/ship/components/weapon/wpn_incom_blaster.iff	@cmd_n:cert_ordnance_level2
object/tangible/ship/components/weapon/wpn_incom_disruptor.iff	@cmd_n:cert_ordnance_level3
object/tangible/ship/components/weapon/wpn_incom_elite_quad_blaster.iff	@cmd_n:cert_ordnance_levelten
object/tangible/ship/components/weapon/wpn_incom_heavy_blaster.iff	@cmd_n:cert_ordnance_level7
object/tangible/ship/components/weapon/wpn_incom_heavy_quad_blaster.iff	@cmd_n:cert_ordnance_level9
object/tangible/ship/components/weapon/wpn_incom_light_blaster.iff	@cmd_n:cert_ordnance_level1
object/tangible/ship/components/weapon/wpn_incom_quad_blaster.iff	@cmd_n:cert_ordnance_level8
object/tangible/ship/components/weapon/wpn_incom_shredder.iff	@cmd_n:cert_ordnance_level2
object/tangible/ship/components/weapon/wpn_incom_tt13.iff	@cmd_n:cert_ordnance_level5
object/tangible/ship/components/weapon/wpn_incom_tt8.iff	@cmd_n:cert_ordnance_level4
object/tangible/ship/components/weapon/wpn_ionic_pulse_weapon.iff	@cmd_n:cert_ordnance_level7
object/tangible/ship/components/weapon/wpn_kdy_pounder_mk1.iff	@cmd_n:cert_ordnance_level4
object/tangible/ship/components/weapon/wpn_kessel_imperial_rendili_prototype_x.iff	@cmd_n:cert_ordnance_level9
object/tangible/ship/components/weapon/wpn_kessel_imperial_sds_experimental_secret_ops.iff	@cmd_n:cert_ordnance_levelten
object/tangible/ship/components/weapon/wpn_kessel_imperial_sfs_elite_ops.iff	@cmd_n:cert_ordnance_level9
object/tangible/ship/components/weapon/wpn_kessel_rebel_incom_dualcore_flashcannon.iff	@cmd_n:cert_ordnance_level9
object/tangible/ship/components/weapon/wpn_kessel_rebel_riiz_combine_slammer_cannon.iff	@cmd_n:cert_ordnance_level9
object/tangible/ship/components/weapon/wpn_kessel_rebel_unknown_rayslinger.iff	@cmd_n:cert_ordnance_levelten
object/tangible/ship/components/weapon/wpn_koensayr_deluxe_ion_accelerator.iff	@cmd_n:cert_ordnance_level4
object/tangible/ship/components/weapon/wpn_koensayr_ion_accelerator.iff	@cmd_n:cert_ordnance_level3
object/tangible/ship/components/weapon/wpn_koensayr_ion_accelerator_2.iff	@cmd_n:cert_ordnance_level5
object/tangible/ship/components/weapon/wpn_koensayr_ion_accelerator_3.iff	@cmd_n:cert_ordnance_level6
object/tangible/ship/components/weapon/wpn_koensayr_ion_accelerator_advanced.iff	@cmd_n:cert_ordnance_level9
object/tangible/ship/components/weapon/wpn_koensayr_light_disruptor.iff	@cmd_n:cert_ordnance_level1
object/tangible/ship/components/weapon/wpn_koensayr_tuned_light_disruptor.iff	@cmd_n:cert_ordnance_level2
object/tangible/ship/components/weapon/wpn_kse_double_blaster.iff	@cmd_n:cert_ordnance_level3
object/tangible/ship/components/weapon/wpn_kse_light_disruptor.iff	@cmd_n:cert_ordnance_level1
object/tangible/ship/components/weapon/wpn_laser_beam_gun.iff	@cmd_n:cert_ordnance_level2
object/tangible/ship/components/weapon/wpn_mandal_advanced_annihilator.iff	@cmd_n:cert_ordnance_level9
object/tangible/ship/components/weapon/wpn_mandal_annihilator_mk2.iff	@cmd_n:cert_ordnance_level7
object/tangible/ship/components/weapon/wpn_mandal_annilhator_mk1.iff	@cmd_n:cert_ordnance_level6
object/tangible/ship/components/weapon/wpn_mandal_elite_annihilator.iff	@cmd_n:cert_ordnance_levelten
object/tangible/ship/components/weapon/wpn_mandal_enhanced_mangler_mk1.iff	@cmd_n:cert_ordnance_level2
object/tangible/ship/components/weapon/wpn_mandal_heavy_annihilator.iff	@cmd_n:cert_ordnance_level8
object/tangible/ship/components/weapon/wpn_mandal_mangler_mk1.iff	@cmd_n:cert_ordnance_level1
object/tangible/ship/components/weapon/wpn_mandal_qv3_disruptor.iff	@cmd_n:cert_ordnance_level3
object/tangible/ship/components/weapon/wpn_mandal_qv5_disruptor.iff	@cmd_n:cert_ordnance_level5
object/tangible/ship/components/weapon/wpn_mandal_super_mangler.iff	@cmd_n:cert_ordnance_level4
object/tangible/ship/components/weapon/wpn_mining_laser_mk1.iff	@cmd_n:cert_ordnance_level2
object/tangible/ship/components/weapon/wpn_mining_laser_mk2.iff	@cmd_n:cert_ordnance_level4
object/tangible/ship/components/weapon/wpn_mining_laser_mk3.iff	@cmd_n:cert_ordnance_level6
object/tangible/ship/components/weapon/wpn_mission_reward_imperial_cygnus_starblaster.iff	@cmd_n:cert_ordnance_level4
object/tangible/ship/components/weapon/wpn_mission_reward_imperial_sds_boltdriver.iff	@cmd_n:cert_ordnance_level7
object/tangible/ship/components/weapon/wpn_mission_reward_neutral_borstel_disruptor.iff	@cmd_n:cert_ordnance_level8
object/tangible/ship/components/weapon/wpn_mission_reward_neutral_hk_military_blaster.iff	@cmd_n:cert_ordnance_level4
object/tangible/ship/components/weapon/wpn_mission_reward_neutral_mandal_light_blaster.iff	@cmd_n:cert_ordnance_level1
object/tangible/ship/components/weapon/wpn_mission_reward_rebel_incom_tricannon.iff	@cmd_n:cert_ordnance_level8
object/tangible/ship/components/weapon/wpn_mission_reward_rebel_taim_ion_driver.iff	@cmd_n:cert_ordnance_level4
object/tangible/ship/components/weapon/wpn_moncal_light_blaster.iff	@cmd_n:cert_ordnance_level2
object/tangible/ship/components/weapon/wpn_prototype_weapon.iff	@cmd_n:cert_ordnance_level1
object/tangible/ship/components/weapon/wpn_prototype_weapon_tie.iff	@cmd_n:cert_ordnance_level1
object/tangible/ship/components/weapon/wpn_rendili_advanced.iff	@cmd_n:cert_ordnance_level9
object/tangible/ship/components/weapon/wpn_rendili_fr13_disruptor.iff	@cmd_n:cert_ordnance_level5
object/tangible/ship/components/weapon/wpn_rendili_fr9_disruptor.iff	@cmd_n:cert_ordnance_level4
object/tangible/ship/components/weapon/wpn_rendili_sc3_disruptor.iff	@cmd_n:cert_ordnance_level6
object/tangible/ship/components/weapon/wpn_rendili_sc8_disruptor.iff	@cmd_n:cert_ordnance_level7
object/tangible/ship/components/weapon/wpn_reward_incom_elite.iff	@cmd_n:cert_ordnance_levelten
object/tangible/ship/components/weapon/wpn_reward_seinar_elite.iff	@cmd_n:cert_ordnance_levelten
object/tangible/ship/components/weapon/wpn_reward_slayn_elite.iff	@cmd_n:cert_ordnance_levelten
object/tangible/ship/components/weapon/wpn_reward_subpro_elite.iff	@cmd_n:cert_ordnance_levelten
object/tangible/ship/components/weapon/wpn_reward_taim_elite.iff	@cmd_n:cert_ordnance_levelten
object/tangible/ship/components/weapon/wpn_rss_imperial_cannon.iff	@cmd_n:cert_ordnance_level5
object/tangible/ship/components/weapon/wpn_sds_elite.iff	@cmd_n:cert_ordnance_level9
object/tangible/ship/components/weapon/wpn_sds_heavy_imperial_spc_forces_cannon.iff	@cmd_n:cert_ordnance_level8
object/tangible/ship/components/weapon/wpn_sds_imperial_blaster_1.iff	@cmd_n:cert_ordnance_level1
object/tangible/ship/components/weapon/wpn_sds_imperial_blaster_2.iff	@cmd_n:cert_ordnance_level6
object/tangible/ship/components/weapon/wpn_sds_imperial_special_forces_cannon.iff	@cmd_n:cert_ordnance_level7
object/tangible/ship/components/weapon/wpn_sds_modified_elite.iff	@cmd_n:cert_ordnance_levelten
object/tangible/ship/components/weapon/wpn_seinar_disruptor.iff	@cmd_n:cert_ordnance_level2
object/tangible/ship/components/weapon/wpn_seinar_ion_cannon.iff	@cmd_n:cert_ordnance_level2
object/tangible/ship/components/weapon/wpn_seinar_linked_cannon.iff	@cmd_n:cert_ordnance_level2
object/tangible/ship/components/weapon/wpn_seinar_ls1.iff	@cmd_n:cert_ordnance_level7
object/tangible/ship/components/weapon/wpn_seinar_ls72.iff	@cmd_n:cert_ordnance_levelten
object/tangible/ship/components/weapon/wpn_sfs_elite.iff	@cmd_n:cert_ordnance_level9
object/tangible/ship/components/weapon/wpn_sfs_imperial_blaster_1.iff	@cmd_n:cert_ordnance_level1
object/tangible/ship/components/weapon/wpn_sfs_imperial_blaster_2.iff	@cmd_n:cert_ordnance_level3
object/tangible/ship/components/weapon/wpn_sfs_imperial_blaster_3.iff	@cmd_n:cert_ordnance_level5
object/tangible/ship/components/weapon/wpn_sfs_imperial_blaster_4.iff	@cmd_n:cert_ordnance_level6
object/tangible/ship/components/weapon/wpn_sfs_imperial_special_forces_blaster.iff	@cmd_n:cert_ordnance_level8
object/tangible/ship/components/weapon/wpn_sfs_improved_imperial_blaster_2.iff	@cmd_n:cert_ordnance_level4
object/tangible/ship/components/weapon/wpn_slayn_deluxe_light_ioncannon.iff	@cmd_n:cert_ordnance_level2
object/tangible/ship/components/weapon/wpn_slayn_ioncannon.iff	@cmd_n:cert_ordnance_level3
object/tangible/ship/components/weapon/wpn_slayn_light_ioncannon.iff	@cmd_n:cert_ordnance_level1
object/tangible/ship/components/weapon/wpn_spacestation_rebel_turret_s01.iff	@cmd_n:cert_ordnance_level1
object/tangible/ship/components/weapon/wpn_spacestation_rebel_turret_s02.iff	@cmd_n:cert_ordnance_level1
object/tangible/ship/components/weapon/wpn_star_destroyer_turret_dome.iff	@cmd_n:cert_ordnance_level1
object/tangible/ship/components/weapon/wpn_star_destroyer_turret_med.iff	@cmd_n:cert_ordnance_level1
object/tangible/ship/components/weapon/wpn_star_destroyer_turret_square.iff	@cmd_n:cert_ordnance_level1
object/tangible/ship/components/weapon/wpn_std_countermeasure.iff	@cmd_n:cert_ordnance_level1
object/tangible/ship/components/weapon/wpn_subpro_advanced_cannon.iff	@cmd_n:cert_ordnance_level5
object/tangible/ship/components/weapon/wpn_subpro_improved_light_ioncannon.iff	@cmd_n:cert_ordnance_level2
object/tangible/ship/components/weapon/wpn_subpro_light_ioncannon.iff	@cmd_n:cert_ordnance_level1
object/tangible/ship/components/weapon/wpn_subpro_modified_tricannon.iff	@cmd_n:cert_ordnance_level4
object/tangible/ship/components/weapon/wpn_subpro_tricannon.iff	@cmd_n:cert_ordnance_level3
object/tangible/ship/components/weapon/wpn_subpro_tripleblaster.iff	@cmd_n:cert_ordnance_level4
object/tangible/ship/components/weapon/wpn_subpro_tripleblaster_mark2.iff	@cmd_n:cert_ordnance_level6
object/tangible/ship/components/weapon/wpn_subpro_tripleblaster_mark3.iff	@cmd_n:cert_ordnance_level7
object/tangible/ship/components/weapon/wpn_taim_elite.iff	@cmd_n:cert_ordnance_levelten
object/tangible/ship/components/weapon/wpn_taim_heavy_laser.iff	@cmd_n:cert_ordnance_level8
object/tangible/ship/components/weapon/wpn_taim_ix4.iff	@cmd_n:cert_ordnance_level4
object/tangible/ship/components/weapon/wpn_taim_ix5.iff	@cmd_n:cert_ordnance_level5
object/tangible/ship/components/weapon/wpn_taim_kx5.iff	@cmd_n:cert_ordnance_level6
object/tangible/ship/components/weapon/wpn_taim_kx8.iff	@cmd_n:cert_ordnance_level7
object/tangible/ship/components/weapon/wpn_taim_kx9.iff	@cmd_n:cert_ordnance_level9
object/tangible/ship/components/weapon/wpn_tieadvanced_blaster.iff	@cmd_n:cert_ordnance_level2
object/tangible/ship/components/weapon/wpn_tiefighter_basic.iff	@cmd_n:cert_ordnance_level1
object/tangible/ship/components/weapon/wpn_tractor_beam_gun.iff	@cmd_n:cert_ordnance_level2
object/tangible/ship/components/weapon/wpn_tractor_pulse_gun.iff	@cmd_n:cert_ordnance_level2
object/tangible/ship/components/weapon/wpn_trandoshan_fg1a.iff	@cmd_n:cert_ordnance_level7
object/tangible/ship/components/weapon/wpn_vengeance_ion_cannon.iff	@cmd_n:cert_ordnance_level8
object/tangible/ship/components/weapon/wpn_vulcan_cannon.iff	@cmd_n:cert_ordnance_levelten
object/tangible/ship/components/weapon/wpn_z95_basic.iff	@cmd_n:cert_ordnance_level1
object/tangible/ship/components/weapon/wpn_z95_blaster.iff	@cmd_n:cert_ordnance_level2
object/tangible/ship/components/weapon/xwing_weapon_s01_test.iff	@cmd_n:cert_ordnance_level1
object/tangible/ship/components/weapon/xwing_weapon_s02_test.iff	@cmd_n:cert_ordnance_level1
object/tangible/ship/components/weapon_capacitor/cap_corellian_cruiser_grade_cap1.iff	@cmd_n:cert_ordnance_level1
object/tangible/ship/components/weapon_capacitor/cap_corellian_cruiser_grade_cap10.iff	@cmd_n:cert_ordnance_level9
object/tangible/ship/components/weapon_capacitor/cap_corellian_cruiser_grade_cap2.iff	@cmd_n:cert_ordnance_level3
object/tangible/ship/components/weapon_capacitor/cap_corellian_cruiser_grade_cap3.iff	@cmd_n:cert_ordnance_level6
object/tangible/ship/components/weapon_capacitor/cap_corellian_cruiser_grade_cap5.iff	@cmd_n:cert_ordnance_level7
object/tangible/ship/components/weapon_capacitor/cap_corellian_cruiser_grade_cap9.iff	@cmd_n:cert_ordnance_level8
object/tangible/ship/components/weapon_capacitor/cap_corellian_deluxe_cruiser_grade_cap2.iff	@cmd_n:cert_ordnance_level4
object/tangible/ship/components/weapon_capacitor/cap_corellian_elite.iff	@cmd_n:cert_ordnance_levelten
object/tangible/ship/components/weapon_capacitor/cap_corellian_standard.iff	@cmd_n:cert_ordnance_level5
object/tangible/ship/components/weapon_capacitor/cap_corellian_tuned_cruiser_grade_cap1.iff	@cmd_n:cert_ordnance_level2
object/tangible/ship/components/weapon_capacitor/cap_cygnus_cygcap_a.iff	@cmd_n:cert_ordnance_level2
object/tangible/ship/components/weapon_capacitor/cap_cygnus_cygcap_b.iff	@cmd_n:cert_ordnance_level3
object/tangible/ship/components/weapon_capacitor/cap_freitek_xd2.iff	@cmd_n:cert_ordnance_level3
object/tangible/ship/components/weapon_capacitor/cap_gallofree_lt22.iff	@cmd_n:cert_ordnance_level4
object/tangible/ship/components/weapon_capacitor/cap_generic.iff	@cmd_n:cert_ordnance_level1
object/tangible/ship/components/weapon_capacitor/cap_haor_chall_old_capacitor.iff	@cmd_n:cert_ordnance_level1
object/tangible/ship/components/weapon_capacitor/cap_huppla_pasa_tisc_old_capacitor.iff	@cmd_n:cert_ordnance_level4
object/tangible/ship/components/weapon_capacitor/cap_incom_bjn825.iff	@cmd_n:cert_ordnance_level3
object/tangible/ship/components/weapon_capacitor/cap_incom_improved_rebel_mk1.iff	@cmd_n:cert_ordnance_level2
object/tangible/ship/components/weapon_capacitor/cap_incom_rebel_mk1.iff	@cmd_n:cert_ordnance_level1
object/tangible/ship/components/weapon_capacitor/cap_incom_special_bjn825.iff	@cmd_n:cert_ordnance_level4
object/tangible/ship/components/weapon_capacitor/cap_kessel_imperial_rendili_hyperbattery.iff	@cmd_n:cert_ordnance_level9
object/tangible/ship/components/weapon_capacitor/cap_kessel_imperial_sds_imperial_finest.iff	@cmd_n:cert_ordnance_levelten
object/tangible/ship/components/weapon_capacitor/cap_kessel_imperial_sfs_array.iff	@cmd_n:cert_ordnance_level9
object/tangible/ship/components/weapon_capacitor/cap_kessel_rebel_armek_array.iff	@cmd_n:cert_ordnance_level9
object/tangible/ship/components/weapon_capacitor/cap_kessel_rebel_deepwell_k33_prototype.iff	@cmd_n:cert_ordnance_levelten
object/tangible/ship/components/weapon_capacitor/cap_kessel_rebel_taim_hypercharger.iff	@cmd_n:cert_ordnance_level9
object/tangible/ship/components/weapon_capacitor/cap_koensayr_custom_light.iff	@cmd_n:cert_ordnance_level2
object/tangible/ship/components/weapon_capacitor/cap_koensayr_deluxe_mk4.iff	@cmd_n:cert_ordnance_level8
object/tangible/ship/components/weapon_capacitor/cap_koensayr_elite_mk5.iff	@cmd_n:cert_ordnance_levelten
object/tangible/ship/components/weapon_capacitor/cap_koensayr_improved_light.iff	@cmd_n:cert_ordnance_level3
object/tangible/ship/components/weapon_capacitor/cap_koensayr_light.iff	@cmd_n:cert_ordnance_level1
object/tangible/ship/components/weapon_capacitor/cap_koensayr_mk3.iff	@cmd_n:cert_ordnance_level5
object/tangible/ship/components/weapon_capacitor/cap_koensayr_mk4.iff	@cmd_n:cert_ordnance_level7
object/tangible/ship/components/weapon_capacitor/cap_koensayr_mk5.iff	@cmd_n:cert_ordnance_level9
object/tangible/ship/components/weapon_capacitor/cap_koensayr_rare_mk2.iff	@cmd_n:cert_ordnance_level4
object/tangible/ship/components/weapon_capacitor/cap_koensayr_tuned_mk3.iff	@cmd_n:cert_ordnance_level6
object/tangible/ship/components/weapon_capacitor/cap_kse_elite_mk5.iff	@cmd_n:cert_ordnance_levelten
object/tangible/ship/components/weapon_capacitor/cap_kse_limited_mk1.iff	@cmd_n:cert_ordnance_level2
object/tangible/ship/components/weapon_capacitor/cap_kse_limited_mk4.iff	@cmd_n:cert_ordnance_level8
object/tangible/ship/components/weapon_capacitor/cap_kse_mk1.iff	@cmd_n:cert_ordnance_level1
object/tangible/ship/components/weapon_capacitor/cap_kse_mk2.iff	@cmd_n:cert_ordnance_level3
object/tangible/ship/components/weapon_capacitor/cap_kse_mk3.iff	@cmd_n:cert_ordnance_level5
object/tangible/ship/components/weapon_capacitor/cap_kse_mk4.iff	@cmd_n:cert_ordnance_level7
object/tangible/ship/components/weapon_capacitor/cap_kse_mk5.iff	@cmd_n:cert_ordnance_level9
object/tangible/ship/components/weapon_capacitor/cap_kse_performance_mk2.iff	@cmd_n:cert_ordnance_level4
object/tangible/ship/components/weapon_capacitor/cap_kse_supercharged_mk3.iff	@cmd_n:cert_ordnance_level6
object/tangible/ship/components/weapon_capacitor/cap_mandal_improved_powermaster_mk3.iff	@cmd_n:cert_ordnance_level6
object/tangible/ship/components/weapon_capacitor/cap_mandal_powermaster_mk1.iff	@cmd_n:cert_ordnance_level1
object/tangible/ship/components/weapon_capacitor/cap_mandal_powermaster_mk2.iff	@cmd_n:cert_ordnance_level3
object/tangible/ship/components/weapon_capacitor/cap_mandal_powermaster_mk3.iff	@cmd_n:cert_ordnance_level5
object/tangible/ship/components/weapon_capacitor/cap_mandal_powermaster_mk4.iff	@cmd_n:cert_ordnance_level7
object/tangible/ship/components/weapon_capacitor/cap_mandal_powermaster_mk5.iff	@cmd_n:cert_ordnance_level9
object/tangible/ship/components/weapon_capacitor/cap_mandal_powersoak.iff	@cmd_n:cert_ordnance_levelten
object/tangible/ship/components/weapon_capacitor/cap_mandal_provider_p1.iff	@cmd_n:cert_ordnance_levelten
object/tangible/ship/components/weapon_capacitor/cap_mandal_rare_powermaster_mk4.iff	@cmd_n:cert_ordnance_level8
object/tangible/ship/components/weapon_capacitor/cap_mandal_special_powermaster_mk1.iff	@cmd_n:cert_ordnance_level2
object/tangible/ship/components/weapon_capacitor/cap_mandal_tuned_powermaster_mk2.iff	@cmd_n:cert_ordnance_level4
object/tangible/ship/components/weapon_capacitor/cap_mission_reward_imperial_rendili_k_class.iff	@cmd_n:cert_ordnance_level6
object/tangible/ship/components/weapon_capacitor/cap_mission_reward_neutral_sorosuub_v1.iff	@cmd_n:cert_ordnance_level6
object/tangible/ship/components/weapon_capacitor/cap_mission_reward_rebel_qualdex_battery_array.iff	@cmd_n:cert_ordnance_level6
object/tangible/ship/components/weapon_capacitor/cap_moncal_advanced.iff	@cmd_n:cert_ordnance_level7
object/tangible/ship/components/weapon_capacitor/cap_moncal_charged_light.iff	@cmd_n:cert_ordnance_level2
object/tangible/ship/components/weapon_capacitor/cap_moncal_deluxe_elite.iff	@cmd_n:cert_ordnance_levelten
object/tangible/ship/components/weapon_capacitor/cap_moncal_elite.iff	@cmd_n:cert_ordnance_level9
object/tangible/ship/components/weapon_capacitor/cap_moncal_enhanced_advanced.iff	@cmd_n:cert_ordnance_level8
object/tangible/ship/components/weapon_capacitor/cap_moncal_heavy.iff	@cmd_n:cert_ordnance_level5
object/tangible/ship/components/weapon_capacitor/cap_moncal_light.iff	@cmd_n:cert_ordnance_level1
object/tangible/ship/components/weapon_capacitor/cap_moncal_modified_heavy.iff	@cmd_n:cert_ordnance_level6
object/tangible/ship/components/weapon_capacitor/cap_moncal_modified_standard.iff	@cmd_n:cert_ordnance_level4
object/tangible/ship/components/weapon_capacitor/cap_moncal_standard.iff	@cmd_n:cert_ordnance_level3
object/tangible/ship/components/weapon_capacitor/cap_novaldex_deluxe_wampa_s1.iff	@cmd_n:cert_ordnance_level7
object/tangible/ship/components/weapon_capacitor/cap_novaldex_experimental.iff	@cmd_n:cert_ordnance_levelten
object/tangible/ship/components/weapon_capacitor/cap_novaldex_experimental_sarlacc_s1.iff	@cmd_n:cert_ordnance_level3
object/tangible/ship/components/weapon_capacitor/cap_novaldex_sarlacc_s1.iff	@cmd_n:cert_ordnance_level2
object/tangible/ship/components/weapon_capacitor/cap_novaldex_sarlacc_s2.iff	@cmd_n:cert_ordnance_level4
object/tangible/ship/components/weapon_capacitor/cap_novaldex_sarlacc_s3.iff	@cmd_n:cert_ordnance_level5
object/tangible/ship/components/weapon_capacitor/cap_novaldex_small_capacitor.iff	@cmd_n:cert_ordnance_level1
object/tangible/ship/components/weapon_capacitor/cap_novaldex_wampa_s1.iff	@cmd_n:cert_ordnance_level6
object/tangible/ship/components/weapon_capacitor/cap_novaldex_wampa_s2.iff	@cmd_n:cert_ordnance_level8
object/tangible/ship/components/weapon_capacitor/cap_novaldex_wampa_s3.iff	@cmd_n:cert_ordnance_level9
object/tangible/ship/components/weapon_capacitor/cap_prototype_capacitor.iff	@cmd_n:cert_ordnance_level1
object/tangible/ship/components/weapon_capacitor/cap_qualdex_conservator_q3.iff	@cmd_n:cert_ordnance_level4
object/tangible/ship/components/weapon_capacitor/cap_qualdex_conservator_q7.iff	@cmd_n:cert_ordnance_level7
object/tangible/ship/components/weapon_capacitor/cap_qualdex_conservator_qx1.iff	@cmd_n:cert_ordnance_level5
object/tangible/ship/components/weapon_capacitor/cap_qualdex_conservator_qx2.iff	@cmd_n:cert_ordnance_level6
object/tangible/ship/components/weapon_capacitor/cap_qualdex_conservator_qx3.iff	@cmd_n:cert_ordnance_level7
object/tangible/ship/components/weapon_capacitor/cap_qualdex_conservator_qx4.iff	@cmd_n:cert_ordnance_level8
object/tangible/ship/components/weapon_capacitor/cap_qualdex_conservator_qx5.iff	@cmd_n:cert_ordnance_level9
object/tangible/ship/components/weapon_capacitor/cap_qualdex_experimental.iff	@cmd_n:cert_ordnance_levelten
object/tangible/ship/components/weapon_capacitor/cap_qualdex_miser_elite.iff	@cmd_n:cert_ordnance_level3
object/tangible/ship/components/weapon_capacitor/cap_qualdex_miser_light.iff	@cmd_n:cert_ordnance_level1
object/tangible/ship/components/weapon_capacitor/cap_qualdex_miser_standard.iff	@cmd_n:cert_ordnance_level2
object/tangible/ship/components/weapon_capacitor/cap_rendili_overseer_j7.iff	@cmd_n:cert_ordnance_level1
object/tangible/ship/components/weapon_capacitor/cap_rendili_overseer_j8.iff	@cmd_n:cert_ordnance_level4
object/tangible/ship/components/weapon_capacitor/cap_reward_mandal_elite.iff	@cmd_n:cert_ordnance_levelten
object/tangible/ship/components/weapon_capacitor/cap_reward_novaldex_elite.iff	@cmd_n:cert_ordnance_levelten
object/tangible/ship/components/weapon_capacitor/cap_reward_qualdex_elite.iff	@cmd_n:cert_ordnance_levelten
object/tangible/ship/components/weapon_capacitor/cap_reward_sorosuub_elite.iff	@cmd_n:cert_ordnance_levelten
object/tangible/ship/components/weapon_capacitor/cap_reward_subpro_elite.iff	@cmd_n:cert_ordnance_levelten
object/tangible/ship/components/weapon_capacitor/cap_rss_imperial_1.iff	@cmd_n:cert_ordnance_level1
object/tangible/ship/components/weapon_capacitor/cap_sds_imperial_1.iff	@cmd_n:cert_ordnance_level2
object/tangible/ship/components/weapon_capacitor/cap_sds_imperial_2.iff	@cmd_n:cert_ordnance_level3
object/tangible/ship/components/weapon_capacitor/cap_sds_special_imperial_2.iff	@cmd_n:cert_ordnance_level4
object/tangible/ship/components/weapon_capacitor/cap_sfs_imperial_1.iff	@cmd_n:cert_ordnance_level1
object/tangible/ship/components/weapon_capacitor/cap_sorosuub_dynamo_mk1.iff	@cmd_n:cert_ordnance_level1
object/tangible/ship/components/weapon_capacitor/cap_sorosuub_dynamo_mk2.iff	@cmd_n:cert_ordnance_level3
object/tangible/ship/components/weapon_capacitor/cap_sorosuub_dynamo_mk3.iff	@cmd_n:cert_ordnance_level6
object/tangible/ship/components/weapon_capacitor/cap_sorosuub_dynamo_mk4.iff	@cmd_n:cert_ordnance_level8
object/tangible/ship/components/weapon_capacitor/cap_sorosuub_enhanced_dynamo_mk1.iff	@cmd_n:cert_ordnance_level2
object/tangible/ship/components/weapon_capacitor/cap_sorosuub_flash.iff	@cmd_n:cert_ordnance_level5
object/tangible/ship/components/weapon_capacitor/cap_sorosuub_premium_dynamo_mk2.iff	@cmd_n:cert_ordnance_level4
object/tangible/ship/components/weapon_capacitor/cap_sorosuub_supercharged_dynamo_mk4.iff	@cmd_n:cert_ordnance_level9
object/tangible/ship/components/weapon_capacitor/cap_sorosuub_tuned_dynamo_mk3.iff	@cmd_n:cert_ordnance_level7
object/tangible/ship/components/weapon_capacitor/cap_sorosuub_turbo.iff	@cmd_n:cert_ordnance_levelten
object/tangible/ship/components/weapon_capacitor/cap_subpro_dauntless_z3.iff	@cmd_n:cert_ordnance_level8
object/tangible/ship/components/weapon_capacitor/cap_subpro_dauntless_z5.iff	@cmd_n:cert_ordnance_level9
object/tangible/ship/components/weapon_capacitor/cap_subpro_defiant_c1.iff	@cmd_n:cert_ordnance_level5
object/tangible/ship/components/weapon_capacitor/cap_subpro_defiant_c2.iff	@cmd_n:cert_ordnance_level7
object/tangible/ship/components/weapon_capacitor/cap_subpro_defiant_c3.iff	@cmd_n:cert_ordnance_level7
object/tangible/ship/components/weapon_capacitor/cap_subpro_experimental.iff	@cmd_n:cert_ordnance_levelten
object/tangible/ship/components/weapon_capacitor/cap_subpro_gallant_a1.iff	@cmd_n:cert_ordnance_level4
object/tangible/ship/components/weapon_capacitor/cap_subpro_improved_valiant_z1.iff	@cmd_n:cert_ordnance_level2
object/tangible/ship/components/weapon_capacitor/cap_subpro_modified_defiant_c1.iff	@cmd_n:cert_ordnance_level6
object/tangible/ship/components/weapon_capacitor/cap_subpro_valiant_z1.iff	@cmd_n:cert_ordnance_level1
object/tangible/ship/components/weapon_capacitor/cap_subpro_valiant_z2.iff	@cmd_n:cert_ordnance_level3
object/tangible/ship/components/weapon_capacitor/cap_tiburon.iff	@cmd_n:cert_ordnance_level7
object/tangible/ship/components/weapon_capacitor/cap_tiefighter_basic.iff	@cmd_n:cert_ordnance_level1
object/tangible/ship/components/weapon_capacitor/cap_tiefighter_elite_mk1.iff	@cmd_n:cert_ordnance_level3
object/tangible/ship/components/weapon_capacitor/cap_tiefighter_elite_mk2.iff	@cmd_n:cert_ordnance_level6
object/tangible/ship/components/weapon_capacitor/cap_tiefighter_elite_mk3.iff	@cmd_n:cert_ordnance_level9
object/tangible/ship/components/weapon_capacitor/cap_tiefighter_experimental.iff	@cmd_n:cert_ordnance_levelten
object/tangible/ship/components/weapon_capacitor/cap_unknown_experimental.iff	@cmd_n:cert_ordnance_level7
object/tangible/ship/components/weapon_capacitor/cap_z95_basic.iff	@cmd_n:cert_ordnance_level1
object/tangible/ship/components/weapon_capacitor/cap_z95_deepwell_experimental.iff	@cmd_n:cert_ordnance_levelten
object/tangible/ship/components/weapon_capacitor/cap_z95_deepwell_k3.iff	@cmd_n:cert_ordnance_level2
object/tangible/ship/components/weapon_capacitor/cap_z95_deepwell_k5.iff	@cmd_n:cert_ordnance_level5
object/tangible/ship/components/weapon_capacitor/weapon_capacitor_test.iff	@cmd_n:cert_ordnance_level1
object/tangible/ship/crafted/armor/adv_durasteel_plating.iff	@cmd_n:cert_ordnance_level7
object/tangible/ship/crafted/armor/base_armor.iff	@cmd_n:cert_ordnance_level1
object/tangible/ship/crafted/armor/durasteel_plating.iff	@cmd_n:cert_ordnance_level3
object/tangible/ship/crafted/armor/elite_armor.iff	@cmd_n:cert_ordnance_levelten
object/tangible/ship/crafted/armor/experimental_armor.iff	@cmd_n:cert_ordnance_level9
object/tangible/ship/crafted/armor/gunship_armor_mk1.iff	@cmd_n:cert_ordnance_levelten
object/tangible/ship/crafted/armor/gunship_armor_mk2.iff	@cmd_n:cert_ordnance_levelten
object/tangible/ship/crafted/armor/gunship_armor_mk3.iff	@cmd_n:cert_ordnance_levelten
object/tangible/ship/crafted/armor/heavy_durasteel_plating.iff	@cmd_n:cert_ordnance_level5
object/tangible/ship/crafted/armor/light_durasteel_plating.iff	@cmd_n:cert_ordnance_level1
object/tangible/ship/crafted/booster/base_booster.iff	@cmd_n:cert_ordnance_level1
object/tangible/ship/crafted/booster/basic_booster.iff	@cmd_n:cert_ordnance_level1
object/tangible/ship/crafted/booster/booster_mk1.iff	@cmd_n:cert_ordnance_level1
object/tangible/ship/crafted/booster/booster_mk2.iff	@cmd_n:cert_ordnance_level3
object/tangible/ship/crafted/booster/booster_mk3.iff	@cmd_n:cert_ordnance_level5
object/tangible/ship/crafted/booster/booster_mk4.iff	@cmd_n:cert_ordnance_level7
object/tangible/ship/crafted/booster/booster_mk5.iff	@cmd_n:cert_ordnance_level9
object/tangible/ship/crafted/booster/collection_reward_booster_01_mk1.iff	@cmd_n:cert_ordnance_level1
object/tangible/ship/crafted/booster/collection_reward_booster_01_mk2.iff	@cmd_n:cert_ordnance_level3
object/tangible/ship/crafted/booster/collection_reward_booster_01_mk3.iff	@cmd_n:cert_ordnance_level5
object/tangible/ship/crafted/booster/collection_reward_booster_01_mk4.iff	@cmd_n:cert_ordnance_level7
object/tangible/ship/crafted/booster/collection_reward_booster_01_mk5.iff	@cmd_n:cert_ordnance_level9
object/tangible/ship/crafted/booster/elite_booster.iff	@cmd_n:cert_ordnance_levelten
object/tangible/ship/crafted/booster/xwing_booster_mk1.iff	@cmd_n:cert_ordnance_level2
object/tangible/ship/crafted/booster/xwing_booster_mk2.iff	@cmd_n:cert_ordnance_level4
object/tangible/ship/crafted/capacitor/base_capacitor.iff	@cmd_n:cert_ordnance_level1
object/tangible/ship/crafted/capacitor/basic_capacitor.iff	@cmd_n:cert_ordnance_level1
object/tangible/ship/crafted/capacitor/capacitor_mk1.iff	@cmd_n:cert_ordnance_level1
object/tangible/ship/crafted/capacitor/capacitor_mk2.iff	@cmd_n:cert_ordnance_level3
object/tangible/ship/crafted/capacitor/capacitor_mk3.iff	@cmd_n:cert_ordnance_level5
object/tangible/ship/crafted/capacitor/capacitor_mk4.iff	@cmd_n:cert_ordnance_level7
object/tangible/ship/crafted/capacitor/capacitor_mk5.iff	@cmd_n:cert_ordnance_level9
object/tangible/ship/crafted/capacitor/capacitor_mk6.iff	@cmd_n:cert_ordnance_level9
object/tangible/ship/crafted/capacitor/collection_reward_capacitor_01_mk1.iff	@cmd_n:cert_ordnance_level1
object/tangible/ship/crafted/capacitor/collection_reward_capacitor_01_mk2.iff	@cmd_n:cert_ordnance_level3
object/tangible/ship/crafted/capacitor/collection_reward_capacitor_01_mk3.iff	@cmd_n:cert_ordnance_level5
object/tangible/ship/crafted/capacitor/collection_reward_capacitor_01_mk4.iff	@cmd_n:cert_ordnance_level7
object/tangible/ship/crafted/capacitor/collection_reward_capacitor_01_mk5.iff	@cmd_n:cert_ordnance_level9
object/tangible/ship/crafted/capacitor/elite_capacitor.iff	@cmd_n:cert_ordnance_levelten
object/tangible/ship/crafted/capacitor/gunship_capacitor_mk1.iff	@cmd_n:cert_ordnance_levelten
object/tangible/ship/crafted/capacitor/gunship_capacitor_mk2.iff	@cmd_n:cert_ordnance_levelten
object/tangible/ship/crafted/capacitor/gunship_capacitor_mk3.iff	@cmd_n:cert_ordnance_levelten
object/tangible/ship/crafted/capacitor/mining_grade_capacitor.iff	@cmd_n:cert_ordnance_levelten
object/tangible/ship/crafted/cargo_hold/crg_crafted_mining_large.iff	@cmd_n:cert_ordnance_levelten
object/tangible/ship/crafted/cargo_hold/crg_crafted_mining_medium.iff	@cmd_n:cert_ordnance_levelten
object/tangible/ship/crafted/cargo_hold/crg_crafted_mining_small.iff	@cmd_n:cert_ordnance_levelten
object/tangible/ship/crafted/cargo_hold/crg_crafted_pob_gunship_huge.iff	@cmd_n:cert_ordnance_levelten
object/tangible/ship/crafted/cargo_hold/crg_crafted_pob_huge.iff	@cmd_n:cert_ordnance_levelten
object/tangible/ship/crafted/cargo_hold/crg_crafted_pob_large.iff	@cmd_n:cert_ordnance_levelten
object/tangible/ship/crafted/cargo_hold/crg_crafted_pob_medium.iff	@cmd_n:cert_ordnance_levelten
object/tangible/ship/crafted/cargo_hold/crg_crafted_pob_small.iff	@cmd_n:cert_ordnance_levelten
object/tangible/ship/crafted/cargo_hold/crg_crafted_starfighter_huge.iff	@cmd_n:cert_ordnance_level7
object/tangible/ship/crafted/cargo_hold/crg_crafted_starfighter_large.iff	@cmd_n:cert_ordnance_level7
object/tangible/ship/crafted/cargo_hold/crg_crafted_starfighter_medium.iff	@cmd_n:cert_ordnance_level5
object/tangible/ship/crafted/cargo_hold/crg_crafted_starfighter_small.iff	@cmd_n:cert_ordnance_level1
object/tangible/ship/crafted/droid_interface/base_droid_interface.iff	@cmd_n:cert_ordnance_level1
object/tangible/ship/crafted/droid_interface/basic_droid_interface.iff	@cmd_n:cert_ordnance_level1
object/tangible/ship/crafted/droid_interface/ddi_mk1.iff	@cmd_n:cert_ordnance_level1
object/tangible/ship/crafted/droid_interface/ddi_mk2.iff	@cmd_n:cert_ordnance_level3
object/tangible/ship/crafted/droid_interface/ddi_mk3.iff	@cmd_n:cert_ordnance_level5
object/tangible/ship/crafted/droid_interface/ddi_mk4.iff	@cmd_n:cert_ordnance_level7
object/tangible/ship/crafted/droid_interface/ddi_mk5.iff	@cmd_n:cert_ordnance_level9
object/tangible/ship/crafted/engine/base_engine.iff	@cmd_n:cert_ordnance_level1
object/tangible/ship/crafted/engine/basic_engine.iff	@cmd_n:cert_ordnance_level1
object/tangible/ship/crafted/engine/collection_reward_engine_01_mk1.iff	@cmd_n:cert_ordnance_level1
object/tangible/ship/crafted/engine/collection_reward_engine_01_mk2.iff	@cmd_n:cert_ordnance_level3
object/tangible/ship/crafted/engine/collection_reward_engine_01_mk3.iff	@cmd_n:cert_ordnance_level5
object/tangible/ship/crafted/engine/collection_reward_engine_01_mk4.iff	@cmd_n:cert_ordnance_level7
object/tangible/ship/crafted/engine/collection_reward_engine_01_mk5.iff	@cmd_n:cert_ordnance_level9
object/tangible/ship/crafted/engine/elite_engine.iff	@cmd_n:cert_ordnance_levelten
object/tangible/ship/crafted/engine/eng_elite_mk2.iff	@cmd_n:cert_ordnance_levelten
object/tangible/ship/crafted/engine/eng_mk1.iff	@cmd_n:cert_ordnance_level1
object/tangible/ship/crafted/engine/eng_mk2.iff	@cmd_n:cert_ordnance_level3
object/tangible/ship/crafted/engine/eng_mk3.iff	@cmd_n:cert_ordnance_level5
object/tangible/ship/crafted/engine/eng_mk4.iff	@cmd_n:cert_ordnance_level7
object/tangible/ship/crafted/engine/eng_mk5.iff	@cmd_n:cert_ordnance_level9
object/tangible/ship/crafted/engine/eng_nova_01.iff	@cmd_n:cert_ordnance_level9
object/tangible/ship/crafted/engine/eng_orion_01.iff	@cmd_n:cert_ordnance_level9
object/tangible/ship/crafted/modification/blacksun_heavy_modification_s01.iff	@cmd_n:cert_ordnance_level1
object/tangible/ship/crafted/modification/hutt_heavy_modification_s01.iff	@cmd_n:cert_ordnance_level1
object/tangible/ship/crafted/modification/tie_advanced_modification_s01.iff	@cmd_n:cert_ordnance_level1
object/tangible/ship/crafted/modification/xwing_modification_s01.iff	@cmd_n:cert_ordnance_level1
object/tangible/ship/crafted/modification/z95_modification_s01.iff	@cmd_n:cert_ordnance_level1
object/tangible/ship/crafted/reactor/base_reactor.iff	@cmd_n:cert_ordnance_level1
object/tangible/ship/crafted/reactor/basic_reactor.iff	@cmd_n:cert_ordnance_level1
object/tangible/ship/crafted/reactor/collection_reward_reactor_01_mk1.iff	@cmd_n:cert_ordnance_level1
object/tangible/ship/crafted/reactor/collection_reward_reactor_01_mk2.iff	@cmd_n:cert_ordnance_level3
object/tangible/ship/crafted/reactor/collection_reward_reactor_01_mk3.iff	@cmd_n:cert_ordnance_level5
object/tangible/ship/crafted/reactor/collection_reward_reactor_01_mk4.iff	@cmd_n:cert_ordnance_level7
object/tangible/ship/crafted/reactor/collection_reward_reactor_01_mk5.iff	@cmd_n:cert_ordnance_level9
object/tangible/ship/crafted/reactor/collection_reward_reactor_02_mk1.iff	@cmd_n:cert_ordnance_level1
object/tangible/ship/crafted/reactor/collection_reward_reactor_02_mk2.iff	@cmd_n:cert_ordnance_level3
object/tangible/ship/crafted/reactor/collection_reward_reactor_02_mk3.iff	@cmd_n:cert_ordnance_level5
object/tangible/ship/crafted/reactor/collection_reward_reactor_02_mk4.iff	@cmd_n:cert_ordnance_level7
object/tangible/ship/crafted/reactor/elite_reactor.iff	@cmd_n:cert_ordnance_levelten
object/tangible/ship/crafted/reactor/fusion_reactor_mk1.iff	@cmd_n:cert_ordnance_level1
object/tangible/ship/crafted/reactor/fusion_reactor_mk2.iff	@cmd_n:cert_ordnance_level3
object/tangible/ship/crafted/reactor/fusion_reactor_mk3.iff	@cmd_n:cert_ordnance_level5
object/tangible/ship/crafted/reactor/fusion_reactor_mk4.iff	@cmd_n:cert_ordnance_level7
object/tangible/ship/crafted/reactor/fusion_reactor_mk5.iff	@cmd_n:cert_ordnance_level9
object/tangible/ship/crafted/reactor/fusion_reactor_mk6.iff	@cmd_n:cert_ordnance_level9
object/tangible/ship/crafted/reactor/gunship_reactor.iff	@cmd_n:cert_ordnance_levelten
object/tangible/ship/crafted/reactor/mining_grade_reactor.iff	@cmd_n:cert_ordnance_levelten
object/tangible/ship/crafted/reactor/mustafar_fusion_reactor.iff	@cmd_n:cert_ordnance_level7
object/tangible/ship/crafted/shields/adv_deflector_shields.iff	@cmd_n:cert_ordnance_level7
object/tangible/ship/crafted/shields/base_shields.iff	@cmd_n:cert_ordnance_level1
object/tangible/ship/crafted/shields/basic_shields.iff	@cmd_n:cert_ordnance_level1
object/tangible/ship/crafted/shields/deflector_shields.iff	@cmd_n:cert_ordnance_level3
object/tangible/ship/crafted/shields/elite_shields.iff	@cmd_n:cert_ordnance_level9
object/tangible/ship/crafted/shields/exp_deflector_shields.iff	@cmd_n:cert_ordnance_level9
object/tangible/ship/crafted/shields/gunship_shields.iff	@cmd_n:cert_ordnance_level9
object/tangible/ship/crafted/shields/heavy_deflector_shields.iff	@cmd_n:cert_ordnance_level5
object/tangible/ship/crafted/shields/light_deflector_shields.iff	@cmd_n:cert_ordnance_level1
object/tangible/ship/crafted/weapon/base_weapon.iff	@cmd_n:cert_ordnance_level1
object/tangible/ship/crafted/weapon/basic_weapon.iff	@cmd_n:cert_ordnance_level1
object/tangible/ship/crafted/weapon/missile/countermeasure_chaff_launcher.iff	@cmd_n:cert_ordnance_level1
object/tangible/ship/crafted/weapon/missile/countermeasure_confuser_launcher.iff	@cmd_n:cert_ordnance_level7
object/tangible/ship/crafted/weapon/missile/countermeasure_decoy_launcher.iff	@cmd_n:cert_ordnance_level3
object/tangible/ship/crafted/weapon/missile/countermeasure_em_launcher.iff	@cmd_n:cert_ordnance_level9
object/tangible/ship/crafted/weapon/missile/countermeasure_microchaff_launcher.iff	@cmd_n:cert_ordnance_level5
object/tangible/ship/crafted/weapon/missile/wpn_launcher_concussion_mk1.iff	@cmd_n:cert_ordnance_level2
object/tangible/ship/crafted/weapon/missile/wpn_launcher_concussion_mk2.iff	@cmd_n:cert_ordnance_level5
object/tangible/ship/crafted/weapon/missile/wpn_launcher_concussion_mk3.iff	@cmd_n:cert_ordnance_level8
object/tangible/ship/crafted/weapon/missile/wpn_launcher_imagerec_mk1.iff	@cmd_n:cert_ordnance_level4
object/tangible/ship/crafted/weapon/missile/wpn_launcher_imagerec_mk2.iff	@cmd_n:cert_ordnance_level7
object/tangible/ship/crafted/weapon/missile/wpn_launcher_proton_mk1.iff	@cmd_n:cert_ordnance_level1
object/tangible/ship/crafted/weapon/missile/wpn_launcher_proton_mk2.iff	@cmd_n:cert_ordnance_level3
object/tangible/ship/crafted/weapon/missile/wpn_launcher_proton_mk3.iff	@cmd_n:cert_ordnance_level6
object/tangible/ship/crafted/weapon/missile/wpn_launcher_proton_mk4.iff	@cmd_n:cert_ordnance_level9
object/tangible/ship/crafted/weapon/missile/wpn_launcher_seismic_mk1.iff	@cmd_n:cert_ordnance_level3
object/tangible/ship/crafted/weapon/missile/wpn_launcher_seismic_mk2.iff	@cmd_n:cert_ordnance_level6
object/tangible/ship/crafted/weapon/missile/wpn_launcher_seismic_mk3.iff	@cmd_n:cert_ordnance_level9
object/tangible/ship/crafted/weapon/missile/wpn_launcher_spacebomb_mk1.iff	@cmd_n:cert_ordnance_level5
object/tangible/ship/crafted/weapon/missile/wpn_launcher_spacebomb_mk2.iff	@cmd_n:cert_ordnance_levelten
object/tangible/ship/crafted/weapon/weapon_incom_disruptor.iff	@cmd_n:cert_ordnance_level2
object/tangible/ship/crafted/weapon/weapon_slayn_ioncannon.iff	@cmd_n:cert_ordnance_level4
object/tangible/ship/crafted/weapon/weapon_subpro_tripleblaster.iff	@cmd_n:cert_ordnance_level4
object/tangible/ship/crafted/weapon/wpn_advanced_blaster.iff	@cmd_n:cert_ordnance_level7
object/tangible/ship/crafted/weapon/wpn_advanced_blaster_green.iff	@cmd_n:cert_ordnance_level7
object/tangible/ship/crafted/weapon/wpn_advanced_disruptor.iff	@cmd_n:cert_ordnance_level7
object/tangible/ship/crafted/weapon/wpn_advanced_ioncannon.iff	@cmd_n:cert_ordnance_level7
object/tangible/ship/crafted/weapon/wpn_crafted_mining_laser_elite.iff	@cmd_n:cert_ordnance_level9
object/tangible/ship/crafted/weapon/wpn_crafted_mining_laser_mk1.iff	@cmd_n:cert_ordnance_level1
object/tangible/ship/crafted/weapon/wpn_crafted_mining_laser_mk2.iff	@cmd_n:cert_ordnance_level5
object/tangible/ship/crafted/weapon/wpn_crafted_mining_laser_mk3.iff	@cmd_n:cert_ordnance_level7
object/tangible/ship/crafted/weapon/wpn_crafted_tractor_beam.iff	@cmd_n:cert_ordnance_level4
object/tangible/ship/crafted/weapon/wpn_elite_gauss.iff	@cmd_n:cert_ordnance_levelten
object/tangible/ship/crafted/weapon/wpn_elite_null_bolt.iff	@cmd_n:cert_ordnance_levelten
object/tangible/ship/crafted/weapon/wpn_elite_railgun.iff	@cmd_n:cert_ordnance_levelten
object/tangible/ship/crafted/weapon/wpn_experimental_blaster.iff	@cmd_n:cert_ordnance_level9
object/tangible/ship/crafted/weapon/wpn_experimental_blaster_green.iff	@cmd_n:cert_ordnance_level9
object/tangible/ship/crafted/weapon/wpn_experimental_disruptor.iff	@cmd_n:cert_ordnance_level9
object/tangible/ship/crafted/weapon/wpn_experimental_ioncannon.iff	@cmd_n:cert_ordnance_level9
object/tangible/ship/crafted/weapon/wpn_heavy_blaster.iff	@cmd_n:cert_ordnance_level5
object/tangible/ship/crafted/weapon/wpn_heavy_blaster_green.iff	@cmd_n:cert_ordnance_level5
object/tangible/ship/crafted/weapon/wpn_heavy_disruptor.iff	@cmd_n:cert_ordnance_level5
object/tangible/ship/crafted/weapon/wpn_heavy_ioncannon.iff	@cmd_n:cert_ordnance_level5
object/tangible/ship/crafted/weapon/wpn_light_blaster.iff	@cmd_n:cert_ordnance_level1
object/tangible/ship/crafted/weapon/wpn_light_blaster_green.iff	@cmd_n:cert_ordnance_level1
object/tangible/ship/crafted/weapon/wpn_light_disruptor.iff	@cmd_n:cert_ordnance_level1
object/tangible/ship/crafted/weapon/wpn_light_ioncannon.iff	@cmd_n:cert_ordnance_level1
object/tangible/ship/crafted/weapon/wpn_medium_blaster.iff	@cmd_n:cert_ordnance_level3
object/tangible/ship/crafted/weapon/wpn_medium_blaster_green.iff	@cmd_n:cert_ordnance_level3
object/tangible/ship/crafted/weapon/wpn_medium_disruptor.iff	@cmd_n:cert_ordnance_level3
object/tangible/ship/crafted/weapon/wpn_medium_ioncannon.iff	@cmd_n:cert_ordnance_level3
object/tangible/ship/crafted/weapon/wpn_nova_ioncannon.iff	@cmd_n:cert_ordnance_level5
object/tangible/ship/crafted/weapon/wpn_orion_disruptor.iff	@cmd_n:cert_ordnance_level5
object/tangible/ship/crafted/weapon/wpn_borstel_experimental.iff	@cmd_n:cert_ordnance_level7
object/tangible/ship/crafted/engine/eng_reward_experimental.iff	@cmd_n:cert_ordnance_level9
object/tangible/ship/crafted/armor/adv_mandal_armor_plating.iff	@cmd_n:cert_ordnance_level7
object/tangible/ship/crafted/reactor/fusion_reactor_mandal.iff	@cmd_n:cert_ordnance_level7
