strScene	strPlanet	useDistributionMap
s	s	i[1]
corellia	corellia	1
dantooine	dantooine	1
dathomir	dathomir	1
endor	endor	1
lok	lok	1
naboo	naboo	1
rori	rori	1
talus	talus	1
tatooine	tatooine	1
yavin4	yavin4	1
kashyyyk_main	kashyyyk	1
kashyyyk_dead_forest	kashyyyk	1
kashyyyk_hunting	kashyyyk	1
kashyyyk_rryatt_trail	kashyyyk	1
kashyyyk_north_dungeons	kashyyyk	1
kashyyyk_south_dungeons	kashyyyk	1
kashyyyk_pob_dungeons	kashyyyk	1
mustafar	mustafar	1
dungeon1	tatooine	0
adventure2	hoth	0
